Order,Predictability,PP1_predictability,PP2_predictability,Len_diff,PP1_len,PP2_len,PP1_distance,PP2_distance,Distance_diff
1,0.891388863351025,5.7033774636008525,5.083927154541016,1,2,3,1,3,2
1,1.002406145928484,4.938146737905649,4.9500286395733175,0,2,2,2,4,2
1,1.0785062147986917,4.103583305112777,4.425740097508286,2,2,4,1,3,2
1,0.9399145823759831,5.613087336222331,5.275822639465332,0,2,2,1,3,2
1,0.9715368851557623,4.0035788796164775,3.8896245541779892,1,5,6,1,6,5
1,1.0332764836907309,4.650003144235322,4.804738898026316,5,2,7,1,3,2
1,1.0523473327634054,5.0164039611816404,5.278999328613281,1,2,3,3,5,2
1,1.0023284818864164,3.793078286307199,3.801910400390625,1,3,4,1,4,3
1,1.0127420342897462,4.817282104492188,4.878664078251008,1,4,5,4,8,4
1,1.0512454094182415,5.794180188860212,6.0911053248814175,0,4,4,1,8,7
1,0.967610289542609,4.739169597625732,4.585669266550164,3,3,6,1,4,3
1,0.9622552801749419,4.576169150216239,4.403442927769253,0,2,2,1,3,2
1,1.1126516763357301,4.306831808651195,4.792003631591797,3,6,9,1,7,6
1,0.9422740378596317,4.4851318359375,4.226223285381611,1,2,3,1,3,2
1,0.9618524222616204,4.985472954644097,4.795289237544222,8,3,11,1,4,3
1,1.0105919376192944,4.5308854386613175,4.578876294587788,1,3,4,1,4,3
1,0.9907796367723705,3.9838709513346355,3.947138214111328,5,2,7,3,5,2
1,1.0500960886034205,5.542090521918403,5.8197275797526045,0,3,3,2,5,3
1,1.0506261692308796,2.8237195696149553,2.9666736744068287,-1,3,2,1,4,3
1,0.8416804237018867,5.468087629838423,4.602382313121449,11,4,15,3,7,4
1,1.0297860094293598,5.447418799767127,5.609675667502663,-4,7,3,2,9,7
1,1.1003192112502795,4.46900646503155,4.917333668675916,3,3,6,2,6,4
1,1.2995110680284925,3.57103370217716,4.640597820281982,-1,5,4,1,7,6
1,1.0452356363999504,4.858908081054688,5.078703880310059,6,5,11,1,6,5
1,0.8507308803675009,4.421672185262044,3.76165307086447,-1,4,3,1,5,4
1,1.01271087242094,4.579965111517137,4.638180463741987,1,4,5,7,10,3
1,0.9374942107647417,4.519157409667969,4.236683909098307,5,5,10,1,8,7
1,1.0138594560037912,4.0794954042176945,4.136034991290118,0,3,3,2,5,3
1,1.1162667808793136,4.005503220991655,4.471210186298077,-5,7,2,14,21,7
1,1.0574981615211885,4.074625015258789,4.308908462524414,0,3,3,1,4,3
1,1.01584840260827,3.680288791656494,3.738615490141369,5,2,7,1,3,2
1,0.5762478746096192,4.403795030381945,2.537677526473999,-1,4,3,1,5,4
1,0.9611945506450833,5.230924288431804,5.02793592087766,-1,4,3,1,5,4
1,0.9606277074914835,4.526865178888494,4.348632118918679,0,2,2,1,3,2
1,1.145386141250397,3.7000318254743303,4.237965175083706,0,2,2,1,3,2
1,0.9923407401847489,4.247709173905222,4.215174865722656,2,4,6,1,5,4
1,0.8383494734087394,5.203573608398438,4.362413194444445,-2,8,6,1,13,12
1,0.9520177612205246,4.613910001866958,4.392524270450368,0,5,5,1,14,13
1,1.148223984451985,3.8912695522966056,4.468049029914701,20,5,25,1,6,5
1,0.9091740796599946,5.03907615260074,4.581397423377404,-6,10,4,1,11,10
1,1.0517651843423885,4.859376173753005,5.110922677176339,1,2,3,4,6,2
1,1.111653348213834,5.025326199001736,5.5864206949869795,6,4,10,1,6,5
1,1.0117798270824792,4.545231587177998,4.598773629324777,-2,6,4,2,7,5
1,1.0042982787344157,5.102582364468961,5.124514685736762,-1,4,3,1,6,5
1,0.778807576573545,5.248805999755859,4.087809880574544,0,3,3,2,5,3
1,0.9908381103713193,3.6970901489257812,3.6632178170340404,6,2,8,1,3,2
1,1.1567982800657592,6.167625427246094,7.134698486328125,4,3,7,1,5,4
1,1.0386722944336526,5.176167668523015,5.376341948638091,0,2,2,1,3,2
1,0.9301605110674094,4.867450651575307,4.527510385664683,2,2,4,1,3,2
1,1.0495905226189788,4.31947766817533,4.533682823181152,6,2,8,1,3,2
1,0.8868979337571959,6.119531419542101,5.427399771554129,-4,6,2,1,9,8
1,0.9895254068278064,4.55040781121505,4.502744140625,6,3,9,1,4,3
1,1.0183856982168393,4.292075157165527,4.370987955729166,-2,4,2,1,5,4
1,0.9984868519435031,4.639406840006511,4.6323867305632564,1,2,3,1,5,4
1,1.1255267367604695,4.127505909312855,4.6456182570684526,-1,3,2,3,6,3
1,0.7901690839038995,4.5719146728515625,3.6125856287339153,3,3,6,1,4,3
1,0.9057916135750363,3.7763197157118054,3.420558728669819,1,3,4,2,6,4
1,1.22467436144058,4.7507758507361775,5.818153381347656,1,2,3,1,3,2
1,1.089675970143189,4.548999633789062,4.956935589130108,1,3,4,1,6,5
1,0.9440961557633208,4.400424957275391,4.1544242858886715,6,5,11,4,9,5
1,0.9355604209635623,4.508256912231445,4.217746734619141,0,2,2,1,3,2
1,0.9635413623409523,4.681940351213727,4.511243184407552,2,2,4,1,3,2
1,1.7954304923990771,2.7540454864501953,4.94469724382673,6,3,9,1,4,3
1,0.9906873205808666,3.993137482673891,3.9559506734212238,-1,4,3,1,5,4
1,1.0059440810561429,5.603868192784926,5.637178039550781,-5,10,5,1,12,11
1,1.1101769782463247,4.120970662434896,4.575006757463727,-1,5,4,1,7,6
1,0.9150506262837514,3.7660681984641333,3.446143063631925,0,3,3,1,5,4
1,1.0023742860864024,4.363536580403646,4.373896864594006,1,2,3,1,3,2
1,1.0496676325773497,5.082012308054957,5.334423828125,6,2,8,1,3,2
1,1.0450148801743375,3.7585638797644414,3.927755182439631,0,2,2,2,5,3
1,0.9084820676903305,4.274168014526367,3.8830049954927883,3,3,6,1,4,3
1,0.936926202256498,4.539028930664062,4.252735137939453,4,8,12,1,9,8
1,1.672691048608169,3.107499694824219,5.197886923085088,13,2,15,3,5,2
1,1.0123496852708578,4.805518256293403,4.864864894321987,1,2,3,3,5,2
1,0.9709620362390731,5.019565037318638,4.873807089669364,0,3,3,1,4,3
1,1.2891907557010542,3.544684410095215,4.569774373372396,7,3,10,1,4,3
1,1.2007748075416773,4.193218924782493,5.0351116473858175,2,3,5,4,7,3
1,1.14054728676416,4.11102294921875,4.688816070556641,-1,3,2,2,5,3
1,1.2128988994040042,3.0812724720348013,3.737271990094866,3,2,5,2,4,2
1,1.137854591649234,3.5453703744070872,4.034115959616268,27,2,29,1,3,2
1,1.053627216022222,3.026674270629883,3.188986385569853,1,2,3,1,3,2
1,0.9613176948112275,4.543763160705566,4.367999927417652,5,2,7,4,6,2
1,1.0059674756214736,5.332026713603252,5.363845453029725,4,2,6,3,5,2
1,1.0152363686662125,5.262284903690733,5.34246301651001,3,2,5,1,3,2
1,0.9150308049603132,5.052516542632004,4.623208279079861,16,4,20,7,11,4
1,0.9407656532495519,4.69661431563528,4.418413434709821,2,2,4,5,7,2
1,1.0368730861016229,3.474734593951513,3.602858781814575,1,3,4,1,5,4
1,0.9341941923439641,4.471098092886118,4.176873871774385,7,2,9,1,3,2
1,1.1122409738103842,3.383201090494792,3.7629348754882814,5,2,7,1,3,2
1,0.9729223932985956,4.085559713429418,3.974932534354074,-1,3,2,1,4,3
1,0.957847152647312,3.916447957356771,3.7513585244455645,1,2,3,1,3,2
1,0.9762352702995449,5.057437672334559,4.93724903307463,4,2,6,1,3,2
1,1.1654226368842786,5.01278068905785,5.842008088764391,-2,4,2,2,6,4
1,0.9630422907238845,4.10999741092805,3.958101321489383,8,3,11,1,5,4
1,0.9626115534705652,5.103145853678385,4.912347157796224,6,3,9,1,5,4
1,1.187510822584003,4.905650926672894,5.825513567243304,5,11,16,1,14,13
1,0.8903171068206093,6.0350218878851996,5.373083226821002,8,3,11,2,5,3
1,0.9197648410960418,3.7663895743233815,3.4641927083333335,4,2,6,2,4,2
1,0.9132729128764012,5.4427538420024675,4.970719655354817,-1,4,3,1,5,4
1,0.6195820296732224,3.536850992838542,2.1913693167946557,-4,7,3,1,8,7
1,0.9622797413233845,4.875188654119318,4.691295276988637,0,3,3,4,8,4
1,0.9169546567819707,3.370564109400699,3.090654456097147,4,4,8,1,7,6
1,1.0414775212978353,6.040045033330503,6.2905711298403535,0,2,2,1,3,2
1,1.5829763764706555,2.791940450668335,4.41957577792081,3,4,7,1,5,4
1,0.9539583031739501,3.54248511272928,3.379383087158203,1,2,3,2,4,2
1,0.7271013250367392,5.753090491661658,4.183079719543457,-10,15,5,1,17,16
1,0.9264452741943395,3.565989685058594,3.3036942915482954,4,3,7,1,4,3
1,1.0286945931194325,4.359884262084961,4.484989367033306,3,2,5,2,4,2
1,1.0294684839544943,4.228679950420673,4.353292737688337,1,2,3,1,5,4
1,0.8892987943143797,5.48427497016059,4.877159118652344,0,3,3,1,4,3
1,1.0310666347259922,4.751976138255635,4.899604045169454,10,3,13,1,4,3
1,1.0789899004592542,3.69233154296875,3.9839884440104165,5,3,8,1,4,3
1,0.8652188254416874,4.9237518310546875,4.260122776031494,5,2,7,2,4,2
1,0.9892392224031642,5.060110684098868,5.005659958411908,0,3,3,1,4,3
1,1.1108697008016626,5.508800252278646,6.119559288024902,1,2,3,1,3,2
1,1.0859574641546172,3.7873001098632812,4.112846823299632,-2,4,2,1,5,4
1,1.0469717868280133,4.8515879313151045,5.079475685402199,0,3,3,1,4,3
1,0.9588343638262877,5.615556262788319,5.384388316761363,1,2,3,3,5,2
1,1.278052747786349,3.2900920867919923,4.204911231994629,2,2,4,1,3,2
1,0.949832306728611,6.041127522786458,5.738058090209961,4,3,7,2,5,3
1,1.160678028575534,4.233542887369792,4.913780212402344,1,3,4,1,4,3
1,0.9800841820592745,4.962347096410291,4.863517895079496,-1,6,5,3,9,6
1,1.0225868462033114,4.923744201660156,5.0349560546875,4,2,6,3,5,2
1,0.8160054119090283,5.201947348458426,4.244817188807896,0,4,4,2,6,4
1,1.0208443523950024,3.727045694986979,3.804733548845564,2,4,6,2,6,4
1,1.064043680936139,3.902909851074219,4.152866564298931,-1,4,3,2,6,4
1,0.9775767023170604,5.188533359103733,5.0721893310546875,-1,3,2,1,4,3
1,1.0587216704652582,3.679869842529297,3.8959579467773438,6,2,8,6,8,2
1,0.9236075286282748,5.028313887746711,4.644188563028972,-7,10,3,1,11,10
1,0.9883971834223564,4.496085611979167,4.44391835530599,0,2,2,4,6,2
1,0.8646753443967238,5.007391611735026,4.32976806640625,1,6,7,4,12,8
1,1.1991717606077805,4.608920627170139,5.5268874629851314,4,4,8,2,6,4
1,1.058007815348985,2.6413219451904295,2.7945392608642576,0,3,3,1,4,3
1,1.0075861770997037,5.262838636125837,5.30276346206665,1,3,4,1,6,5
1,1.0029462227635542,3.5744869232177736,3.5850181579589844,0,3,3,1,4,3
1,1.1366573464859748,4.102375030517578,4.662994716478431,10,3,13,7,10,3
1,1.0704921510586645,4.434803209806743,4.7474220275878904,1,2,3,2,4,2
1,1.0587542920260749,4.605694580078125,4.876298904418945,-5,9,4,1,12,11
1,0.9283946206100889,3.544525146484375,3.2907180786132812,1,3,4,1,4,3
1,1.0092759306860823,4.389677515569723,4.430395859938401,-1,6,5,1,7,6
1,0.8987490129954561,4.4307056003146705,3.98209228515625,1,3,4,1,4,3
1,1.079903112855953,4.223680877685547,4.561166127522786,14,4,18,2,8,6
1,0.914526207568347,4.400218418666294,4.024115062895275,0,4,4,1,5,4
1,1.0479719888693928,4.750377454255757,4.978262508616728,13,3,16,1,4,3
1,0.8192769977946568,5.400286356608073,4.424330393473308,3,3,6,1,4,3
1,1.0597204513853375,6.026910400390625,6.386840209960938,0,2,2,1,3,2
1,0.9539173622594354,4.421148861155791,4.217410659790039,3,2,5,1,3,2
1,1.0836737673940813,3.4799449920654295,3.7711250998757104,2,2,4,1,3,2
1,1.082424462377345,3.745797634124756,4.05454299029182,2,2,4,2,4,2
1,1.036218271104127,4.925413404192243,5.103803362165179,0,2,2,1,3,2
1,0.9796785670344362,4.154640197753906,4.0702119554792136,6,3,9,1,5,4
1,0.9733273777781868,4.0350390116373696,3.9274139404296875,2,2,4,2,4,2
1,1.0212100331243377,4.812311417017227,4.914380701576791,2,3,5,4,7,3
1,0.9078635253705121,4.308940505981445,3.911929918372113,3,3,6,1,4,3
1,1.0735604285878066,5.261066270911175,5.648072560628255,1,3,4,1,4,3
1,1.0476312455368646,4.436166158536586,4.6474662780761715,-1,3,2,1,4,3
1,0.9886774933629017,4.231624603271484,4.183712005615234,2,2,4,6,10,4
1,0.9811941813873429,3.2456158724698154,3.1845794090857873,2,3,5,1,6,5
1,0.9542581089672348,4.09447261265346,3.9071836925688244,7,10,17,1,13,12
1,0.9132614652838092,4.748773120698475,4.336871498509457,-2,4,2,1,5,4
1,1.0913835641335108,4.5684351603190105,4.985915047781808,6,2,8,1,3,2
1,1.0120382240867423,4.594991411481585,4.650306947769657,3,8,11,1,11,10
1,0.8691719930577535,5.615288229549632,4.880651262071398,1,2,3,3,5,2
1,1.0089427025172961,5.2059079950506035,5.252462881582755,10,2,12,1,3,2
1,0.9211062152539292,4.680897521972656,4.311603800455729,10,5,15,1,8,7
1,1.122608421334873,4.659139296587775,5.230389010521673,-3,6,3,1,7,6
1,1.2274451510809936,4.726082249691612,5.801006740993923,8,4,12,2,6,4
1,0.9542266158755074,5.205180867513021,4.966922124226888,-3,5,2,1,6,5
1,0.972877917449963,3.7254670795641447,3.624424653894761,-2,4,2,4,8,4
1,1.0113855143740293,6.241038395808293,6.312095828172637,2,2,4,14,16,2
1,1.082018405200595,4.620162632154382,4.999101003011067,1,3,4,3,6,3
1,0.9165617791688316,3.8038132611443016,3.4864298502604165,-1,4,3,17,21,4
1,0.9954377517940386,3.6993848360501804,3.68250732421875,-1,4,3,1,5,4
1,0.9907923825872724,5.819183349609375,5.765602535671658,-1,5,4,2,7,5
1,0.9469345330180527,5.108720952814275,4.8376242897727275,0,2,2,1,3,2
1,0.920126643210694,5.4760080973307295,5.038620948791504,-5,7,2,1,8,7
1,1.0189927723757317,5.488892798330269,5.59314208984375,-1,3,2,2,5,3
1,1.2448219701360739,3.594177669949002,4.474111328125,16,2,18,2,4,2
1,1.4757856749130747,2.944192409515381,4.344996982150608,1,2,3,1,3,2
1,1.0438872433005317,4.336459350585938,4.526774597167969,5,2,7,1,4,3
1,1.1307601610385136,4.349882943289621,4.918674337452855,1,3,4,2,5,3
1,1.0494659578729848,3.857822049048639,4.048652912008351,-2,4,2,1,5,4
1,0.9921604195530875,5.658778471105239,5.614416022049753,4,2,6,2,4,2
1,0.8238063542526006,5.266295539008246,4.338407728407118,0,2,2,1,4,3
1,0.8066155629716072,5.14203252019109,4.147643456092248,-11,16,5,12,32,20
1,2.022295874367473,2.016737529209682,4.07843998500279,14,2,16,1,3,2
1,0.9790231317335111,5.845437622070312,5.722818647112165,4,2,6,2,4,2
1,0.9670097598543879,4.737982914365571,4.581675720214844,1,4,5,3,7,4
1,1.093187662801423,4.397499416185462,4.807292108950407,0,2,2,1,3,2
1,0.9823879797637716,3.9433971902598506,3.8739459991455076,-3,6,3,6,12,6
1,1.0779636272841053,4.674779451810396,5.039242214626736,5,4,9,1,5,4
1,1.1167072787886854,2.756324132283529,3.078007221221924,2,3,5,1,4,3
1,0.9650953375793431,5.661638895670573,5.464021301269531,0,3,3,1,4,3
1,0.9603020914204676,5.337410990397135,5.125526936848958,0,5,5,3,8,5
1,1.2948037014098854,3.362208366394043,4.353399837718291,9,3,12,3,6,3
1,0.8993139016674564,2.954172307794744,2.656728224320845,0,2,2,1,3,2
1,1.0380686606053886,3.4404754638671875,3.5714497566223145,14,5,19,2,7,5
1,1.0009966798918948,5.460679589248285,5.466122138790968,0,3,3,1,4,3
1,1.0043054298313772,4.9244384765625,4.945640300882274,0,5,5,3,8,5
1,0.8363621451461036,5.607906886509487,4.690241033380682,-3,5,2,1,6,5
1,1.046422641447051,4.244003650753997,4.4410215105329245,-1,3,2,1,4,3
1,0.8021634471981298,5.257204055786133,4.217136928013393,8,8,16,1,10,9
1,1.0736455079676002,4.803721110026042,5.157493591308594,8,3,11,5,8,3
1,1.007063503880393,3.4648969096522175,3.4893712224187077,6,4,10,1,5,4
1,1.0573015823088368,5.56050060641381,5.879126089590567,-4,6,2,1,7,6
1,1.2224590650796374,4.164411718195135,5.090822855631511,-4,6,2,1,7,6
1,0.968318067603696,3.7551830516142,3.6362115960372123,2,3,5,1,4,3
1,0.9552869824399769,5.449477584273727,5.2058149973551435,-3,7,4,1,8,7
1,1.1554864230527204,3.813637097676595,4.406605888815487,5,2,7,1,3,2
1,1.0496038184227772,4.424589677290483,4.644066220238095,-1,3,2,2,5,3
1,1.0781593940612642,4.268360137939453,4.601972579956055,0,2,2,2,4,2
1,0.9755577385765815,4.213892211914063,4.110895156860352,7,2,9,2,4,2
1,0.8290282615695188,3.023130416870117,2.506260553995768,0,2,2,1,3,2
1,0.9899394841382858,4.480017852783203,4.434946562114515,-1,3,2,1,4,3
1,1.1248094368276804,3.7162399291992188,4.180061741879112,1,3,4,1,4,3
1,1.1211494175546532,3.72352663675944,4.174629720052083,3,4,7,1,5,4
1,1.0290420450218574,3.884998321533203,3.9978266176970108,3,3,6,2,5,3
1,0.8851362570969257,5.374830392690805,4.757457256317139,3,2,5,1,3,2
1,1.0320122565246928,4.423730638292101,4.56534423828125,1,4,5,2,7,5
1,0.9782883444823027,4.3742962461529356,4.279323032924107,-12,15,3,1,16,15
1,0.9448900927313754,4.3033192952473955,4.066163767939028,2,3,5,1,4,3
1,0.8729898837542681,5.904584248860677,5.154642317030165,3,3,6,1,4,3
1,1.1226120770771575,4.152698863636363,4.661869896782769,-2,5,3,1,6,5
1,0.8478216287870806,4.207459949311756,3.567175547281901,3,2,5,1,3,2
1,1.005555124651128,4.046341289173473,4.068819219415838,0,2,2,1,3,2
1,1.1083849210473389,5.329906463623047,5.9075879548725325,1,2,3,1,5,4
1,1.0820377013709392,4.687286376953125,5.071820576985677,0,3,3,1,4,3
1,0.9662419646865482,4.369244743795956,4.221747625441778,4,3,7,1,4,3
1,1.0469634695784884,3.649616935036399,3.821015608938117,-3,6,3,1,7,6
1,1.105077619345083,4.269987253042368,4.718667348225911,-2,6,4,9,15,6
1,1.4481006532317902,3.1244723796844482,4.5245504940257355,1,4,5,2,6,4
1,1.0137204619996436,4.755287973504317,4.820532721442145,-1,3,2,3,6,3
1,1.110114341245301,4.533045291900635,5.032198588053386,-1,3,2,1,4,3
1,1.0931393633707052,4.027598063151042,4.4027259826660154,1,2,3,1,4,3
1,0.9968251931663143,4.374767030988421,4.360877990722656,0,2,2,1,3,2
1,0.9651733694367778,3.9281444549560547,3.7913404192243303,0,2,2,1,3,2
1,0.9418581922357875,4.581763527610085,4.315371513366699,-3,5,2,1,6,5
1,1.087012610299468,3.870772043863932,4.207578023274739,18,4,22,2,7,5
1,1.1844326559565963,4.869636535644531,5.767756535456731,0,3,3,2,5,3
1,1.399989725652921,2.796441078186035,3.914988777854226,3,2,5,1,3,2
1,1.2750179654424836,4.434317588806152,5.65383459020544,19,4,23,1,6,5
1,0.9793449505163832,4.282085071910512,4.193638392857143,3,2,5,1,4,3
1,1.003377303439546,4.611879175359553,4.627454890761265,-1,4,3,1,5,4
1,1.205067670924598,4.359780021335768,5.2538299560546875,3,5,8,1,8,7
1,0.9334700682137153,4.22162769458912,3.9407630920410157,3,3,6,1,4,3
1,0.9881227021761408,5.214259807880108,5.1523284912109375,2,4,6,1,5,4
1,1.2900209299167493,4.095884323120117,5.283776503342849,1,2,3,1,3,2
1,1.5524426634910895,2.5850799560546873,4.0131884123149675,4,7,11,1,8,7
1,1.1406258152541324,4.632790842363911,5.284280831473215,4,2,6,1,3,2
1,0.9298724115932429,4.842975192599827,4.503349021629051,0,4,4,3,9,6
1,1.3701327108108492,3.4424654642740884,4.716634538438585,3,2,5,1,3,2
1,0.913658312531186,5.669693686745384,5.180162766400506,6,2,8,2,4,2
1,1.109187208926358,4.822225423959585,5.348750758815456,11,2,13,3,5,2
1,1.1389169524324276,3.175376129150391,3.6164897038386417,-7,11,4,1,12,11
1,0.8822344213048162,4.82624626159668,4.257880577674279,-3,6,3,1,7,6
1,1.0781578791033903,3.5584592819213867,3.8365809122721353,7,2,9,1,3,2
1,0.9530561478183175,5.001816749572754,4.767012203440947,5,3,8,1,4,3
1,1.0314685664691696,4.373366038004558,4.510989597865513,4,3,7,4,7,3
1,0.982816370213409,4.859528198242187,4.776023864746094,0,3,3,1,6,5
1,1.1388942388621173,4.715908432006836,5.370920944213867,0,4,4,1,6,5
1,1.0809992183928991,4.471588897705078,4.833784103393555,-2,4,2,4,8,4
1,0.6715366444782799,4.051648712158203,2.7208305807674633,7,5,12,1,8,7
1,0.9958931540353984,4.997444484544837,4.976920749830163,0,2,2,14,16,2
1,0.9298481252782612,5.10846922132704,4.750100528492647,-1,5,4,1,6,5
1,0.9937448403126199,4.066690921783447,4.041253120668473,-1,3,2,1,4,3
1,1.099281691159066,3.579758780343192,3.935163285997179,4,2,6,1,3,2
1,1.0806931134374396,3.4497330405495386,3.7281027401194855,6,3,9,1,4,3
1,1.0781593940612642,4.268360137939453,4.601972579956055,0,2,2,2,4,2
1,0.9766272841881937,5.078553230531754,4.959853649139404,1,2,3,8,10,2
1,1.085307589073528,3.89552829140111,4.227846418108259,2,3,5,1,4,3
1,0.9626775465492989,4.395199046415441,4.231159434599035,0,2,2,3,5,2
1,0.9580170057544684,5.391810607910156,5.165446254185268,5,4,9,2,6,4
1,0.9661443854311046,5.376306806291852,5.194288635253907,1,2,3,1,3,2
1,1.0090119977529648,4.598379064489294,4.639819646285752,5,5,10,1,6,5
1,0.9526174377405932,5.353504180908203,5.099841435750325,0,3,3,1,4,3
1,1.169036318513068,3.3322039517489346,3.895467440287272,13,2,15,1,4,3
1,1.0193736663237811,4.003752274946733,4.081319635564631,0,3,3,1,4,3
1,0.9840464596657191,4.782329014369419,4.706033935546875,4,2,6,1,3,2
1,1.0113893021413023,4.128324775285618,4.1753435134887695,3,3,6,1,4,3
1,0.968339061610661,6.987806797027588,6.766566276550293,0,2,2,4,6,2
1,1.2873726416428082,3.765557861328125,4.847676171196832,3,3,6,3,6,3
1,1.262873187525333,2.9834118893271997,3.767670882375617,0,4,4,1,5,4
1,1.0190482981036215,4.813055419921875,4.904735934349798,1,4,5,2,7,5
1,1.0034313826653285,4.649564009446364,4.665518442789714,-2,6,4,1,7,6
1,0.8182363692234791,3.185210863749186,2.606255372365316,0,2,2,1,3,2
1,0.8615102032603147,4.7183278401692705,4.06488757663303,6,2,8,1,3,2
1,0.9851600024040528,4.720369692201968,4.650319417317708,0,3,3,1,4,3
1,0.9926275396685386,5.976734924316406,5.932671683175223,-2,4,2,1,6,5
1,1.043260546157015,4.531073111074942,4.72708980853741,-1,4,3,4,8,4
1,0.99402344197359,5.7467101247687085,5.712364578247071,2,2,4,1,3,2
1,1.0717143216808205,3.7576395670572915,4.027116139729817,3,2,5,2,4,2
1,1.0822684820653383,4.450197086777798,4.816308045998598,-4,8,4,1,10,9
1,1.12342599788779,2.895134925842285,3.252469843084162,-2,6,4,1,7,6
1,1.0619608619150944,3.3147399119841747,3.520124053955078,1,2,3,5,7,2
1,1.0863329257744203,4.7632080078125,5.174429691199101,3,2,5,1,3,2
1,1.1966250154111076,3.5598590248509456,4.259816360473633,21,3,24,3,7,4
1,1.0262255041791775,3.258536529541016,3.3439932929144964,-1,4,3,3,7,4
1,0.9130528985028272,4.443851470947266,4.057471466064453,0,4,4,3,7,4
1,1.0579505141856849,4.280649185180664,4.528715006510416,-1,3,2,4,7,3
1,1.002558528020127,4.0553515034337195,4.065727233886719,5,3,8,1,4,3
1,1.0735942680518273,3.037191054400276,3.260710906982422,3,2,5,2,4,2
1,0.97971331982086,3.679501286259404,3.604856420446325,0,3,3,1,4,3
1,0.9204819848022446,4.03587646484375,3.714951578776042,0,5,5,1,6,5
1,0.8688029832360812,3.068292999267578,2.665742111206055,0,2,2,1,5,4
1,0.8498599873534268,3.317562796852805,2.819463876577524,2,2,4,1,3,2
1,0.8804644276389894,3.89394293891059,3.428478240966797,4,3,7,1,4,3
1,1.2182957025573937,4.5608467102050785,5.556459947065874,1,2,3,5,7,2
1,0.9960346835536724,6.715822143554687,6.689191783558239,5,2,7,1,14,13
1,0.9981264474847715,5.31059420838648,5.30064453125,1,2,3,3,5,2
1,1.084922792430213,4.597672333588472,4.988119506835938,3,2,5,1,3,2
1,1.0743814409606056,3.7651505243210566,4.0452078457536365,8,5,13,7,13,6
1,0.8505363387102962,5.585063171386719,4.750299181256976,4,2,6,3,5,2
1,1.006591629316014,3.8786290486653647,3.9041955336084904,5,3,8,2,5,3
1,1.085933330299021,3.881839952970806,4.2154193878173825,1,2,3,2,4,2
1,1.0577593383682653,4.108687506781684,4.346002578735352,1,2,3,1,3,2
1,1.0199788600067337,4.111484527587891,4.193627301384421,1,2,3,1,3,2
1,0.9845765991812587,4.413841453758446,4.345765007866754,-1,4,3,1,5,4
1,1.0340759261143944,5.035142262776692,5.206719398498535,-2,7,5,1,8,7
1,1.1194293807748457,3.081537170410156,3.4495632465069113,1,2,3,1,3,2
1,1.0456678107326127,4.425454275948661,4.627555084228516,-1,3,2,1,4,3
1,0.8234192192574007,4.204690933227539,3.462223325456892,-2,6,4,5,12,7
1,0.8638761881648853,5.550407409667969,4.7948647958261,3,4,7,1,5,4
1,0.9801801445330691,4.971546427408854,4.873011095770474,-1,4,3,3,7,4
1,1.0193217124621068,4.306941562228733,4.390159048685214,5,2,7,1,3,2
1,1.1304847475911737,3.5419532374331824,4.004124111599392,-1,3,2,5,8,3
1,1.2523297858395588,3.561603546142578,4.460302206186148,2,2,4,1,3,2
1,1.0407988393836944,4.443734486897786,4.625033696492513,0,5,5,2,7,5
1,1.067660751194247,3.8559024517352762,4.116795708151424,8,2,10,1,3,2
1,1.0280223263292978,3.5637791951497397,3.6636445787217884,0,4,4,1,5,4
1,1.1054511414696786,4.1642372824928975,4.603360857282366,3,4,7,1,5,4
1,0.9834266997850888,4.293532661769701,4.222374655983665,-1,3,2,3,6,3
1,1.2360258070491592,4.624172634548611,5.715596712552584,17,2,19,1,3,2
1,1.0041215683358538,5.063047409057617,5.083915104941716,-1,3,2,7,10,3
1,1.0621015513009306,4.2481343405587335,4.511950073242187,-3,6,3,1,9,8
1,0.9514338179564747,3.800602595011393,3.6160218375069753,2,3,5,3,6,3
1,1.0795754242048412,4.504164123535157,4.862584894353693,1,2,3,1,3,2
1,1.0065268408014685,5.119529574525123,5.152943929036458,6,4,10,5,11,6
1,1.0421581877194876,4.420060157775879,4.6064018836388225,-6,9,3,5,14,9
1,0.9067946878086345,4.937786865234375,4.477558898925781,5,2,7,1,3,2
1,1.011966354900019,4.22954953950027,4.280161830357143,6,5,11,5,10,5
1,1.1779122859331592,3.7854558041221216,4.458934899532434,14,3,17,1,4,3
1,0.9002598563170063,5.830560572007123,5.249019622802734,-1,5,4,1,6,5
1,0.9818432969574497,4.136360531761532,4.061257861909413,0,3,3,1,4,3
1,1.0183272351062642,3.8446214948381696,3.9150827768686653,2,4,6,7,11,4
1,1.2486073608765516,3.9786216735839846,4.967736307779948,10,5,15,2,7,5
1,0.8755492604362654,5.154074532645089,4.512646145290798,2,3,5,1,4,3
1,1.1319264919086243,3.5792238572064567,4.051418304443359,-2,6,4,1,8,7
1,1.4087307780652265,3.4129694158380683,4.807955060686384,6,5,11,1,6,5
1,1.0981733974570758,3.6113887968517484,3.965931104577106,2,2,4,1,3,2
1,1.3726499347664276,3.6867125374930247,5.060565724092371,3,4,7,1,6,5
1,1.066770266541957,4.111114501953125,4.38561471303304,1,4,5,1,6,5
1,0.9891664409357833,5.29728522667518,5.239896774291992,-1,3,2,2,4,2
1,0.9390454016100919,5.149874732607887,4.835966186523438,4,2,6,1,3,2
1,1.2764361182880128,3.968024155189251,5.064929349922839,52,12,64,7,20,13
1,1.110065206164246,4.5358717782156805,5.0351134406195746,2,2,4,1,3,2
1,1.035474413688973,4.609920192409206,4.77345440838788,0,2,2,2,4,2
1,0.9984933210147473,5.405863268622037,5.3977183680380545,2,3,5,1,4,3
1,0.8866330387652923,4.626776559012277,4.102252960205078,2,2,4,3,5,2
1,1.0086373966244755,4.468644655667818,4.507242111932664,-5,8,3,1,9,8
1,0.8973050924583356,5.586887961939762,5.01314301924272,3,2,5,3,5,2
1,1.3251417693541088,3.1855100631713866,4.22125244140625,1,2,3,2,4,2
1,1.091271147464677,4.317786080496652,4.711875370570591,0,5,5,3,8,5
1,1.014170592534506,4.766929159359056,4.8344793701171875,1,2,3,7,9,2
1,0.8664520344999839,5.39136438784392,4.671358642578125,2,4,6,1,12,11
1,0.8636783158292921,4.259683227539062,3.6789960359272205,-6,8,2,1,9,8
1,0.7199386472746275,5.786083514873798,4.165625138716265,9,3,12,1,4,3
1,1.034113977852,4.630437622070312,4.788400268554687,0,6,6,1,7,6
1,0.818753453942345,2.8934218088785806,2.3689990997314454,4,2,6,1,3,2
1,1.39424786970046,3.3919578552246095,4.729230013760653,1,2,3,1,4,3
1,0.9926224500909839,4.960446958188657,4.923851013183594,-1,6,5,9,19,10
1,1.1211429953572922,4.134958902994792,4.635880210182884,10,2,12,1,3,2
1,1.0560123894334261,3.7806509108770463,3.9924142020089284,0,5,5,1,6,5
1,1.0171034992086363,4.187328762478298,4.2589467366536455,6,2,8,1,3,2
1,0.9302578525698264,3.702529243800951,3.444306903415256,-5,7,2,1,8,7
1,1.295444536498401,3.9494428634643555,5.1162841796875,12,2,14,1,3,2
1,1.0522560925181923,4.186822744516226,4.405609741210937,-1,3,2,3,6,3
1,1.048559020255131,5.004922866821289,5.247957017686632,2,2,4,1,3,2
1,1.225453141998767,4.413613752885298,5.408676841042259,11,3,14,1,4,3
1,0.9965829289373592,5.124457139235276,5.1069465050330525,0,3,3,6,9,3
1,1.1581815463531742,4.278079986572266,4.954793294270833,1,3,4,1,4,3
1,0.9241622324253209,4.087331331693209,3.7773572481595554,0,4,4,7,11,4
1,0.990165767272514,4.910666465759277,4.8623738288879395,0,3,3,1,4,3
1,0.9107274861037455,4.575142308285362,4.166707852991616,3,2,5,1,3,2
1,0.9292123802884754,5.203854768172555,4.835486275809152,-4,6,2,1,9,8
1,0.8536565345662768,5.31135735144982,4.534074910481771,4,3,7,1,4,3
1,1.1732749708480774,4.951255162556966,5.809183756510417,12,2,14,5,7,2
1,0.9094337345796462,2.8503405253092446,2.5921958287556968,0,2,2,2,5,3
1,1.0486889065450422,3.5141489846365794,3.685249056134905,0,3,3,1,4,3
1,0.9840389040282737,5.321913620521283,5.236970046470905,0,5,5,5,10,5
1,0.9044013022152991,3.952587259226832,3.5747250643643467,4,3,7,8,11,3
1,0.9698745631512211,4.959170205252511,4.809773036411831,0,3,3,5,9,4
1,1.1068533937332046,4.674385706583659,5.1738596829501065,-1,3,2,1,4,3
1,1.0623740619316138,5.354381016322544,5.688355509440104,1,6,7,1,7,6
1,0.9280288126754822,5.0767870451274675,4.711404653695913,-6,10,4,1,11,10
1,1.1298353562534083,2.62122072492327,2.9615478515625,2,5,7,1,6,5
1,1.090191573399807,4.142091230912642,4.515672956194196,16,3,19,1,5,4
1,1.0822005033474615,4.1288036770290795,4.46819341750372,3,4,7,7,11,4
1,0.9178287894096132,5.239338121916118,4.808815365745907,2,2,4,1,3,2
1,1.0139093997790904,5.241898672921317,5.314810337164463,11,4,15,3,12,9
1,1.1576771488292237,4.4216638380481355,5.118859185112847,5,2,7,1,3,2
1,1.461710348512178,3.1701927185058594,4.633903503417969,12,6,18,1,7,6
1,1.015216624020465,4.782450936057351,4.855223693847656,3,2,5,1,3,2
1,0.9522809308705027,4.260402478669819,4.0571000382706925,18,2,20,1,3,2
1,1.2033084645920598,4.003503899825247,4.817450130687041,-2,4,2,2,6,4
1,1.415858589097575,4.074515342712402,5.768937544389204,3,3,6,1,4,3
1,1.0128158919262458,2.3980542233115747,2.428787427070813,1,3,4,3,6,3
1,1.10377850869883,4.279713221958706,4.723855477792245,-1,4,3,2,6,4
1,1.0297409866653602,4.289674799493018,4.417253960503472,-2,4,2,1,5,4
1,1.008720588214251,4.443176814488003,4.48192392985026,32,2,34,1,4,3
1,0.9144967746461106,5.530348459879558,5.05748582922894,-1,4,3,1,5,4
1,1.074572365783148,5.157312711079915,5.5419057210286455,0,3,3,3,6,3
1,0.9987645295131321,4.5590966796875,4.553464050292969,0,3,3,1,4,3
1,1.0380793888985473,4.600324959590517,4.775502522786458,2,7,9,1,8,7
1,1.0585396548800048,4.4846942608173075,4.747226715087891,7,3,10,2,5,3
1,1.0240762189074766,3.8802769978841147,3.9736993963068183,4,3,7,1,4,3
1,1.0220919883205097,4.927458953857422,5.036316319515831,-1,4,3,1,5,4
1,1.1277612281768719,4.5914154052734375,5.178020276521382,4,2,6,8,10,2
1,1.000517112915961,5.061583613006162,5.064201023267663,-2,5,3,1,6,5
1,1.2332460976246162,4.558604649135044,5.621881394159226,7,2,9,4,7,3
1,0.9201349209911238,3.7165856794877485,3.4197602705522017,0,3,3,3,6,3
1,0.8932194942900056,3.788145065307617,3.38364501953125,1,3,4,1,4,3
1,1.2389135114493641,3.7677364349365234,4.667899576822917,1,2,3,1,3,2
1,0.9500924219612403,3.3136374529670265,3.148261833190918,3,2,5,1,3,2
1,1.3020309041046252,4.285642941792806,5.580039554172092,6,3,9,4,7,3
1,0.7318931167684648,5.2689995398888225,3.8563444955008372,1,2,3,3,5,2
1,0.9899224218818949,4.778120561079546,4.729968677867543,0,5,5,12,17,5
1,1.0965843627739928,4.859214435924184,5.328538565800108,7,2,9,1,3,2
1,1.0389236761050096,4.363231790476832,4.5330648114604335,2,2,4,1,6,5
1,1.1530732892268618,3.5506362915039062,4.094143867492676,-1,3,2,1,4,3
1,0.990073317946462,4.1051492130055145,4.064398701985677,-2,4,2,1,5,4
1,0.4935166333447992,3.865777015686035,1.9078252580430772,1,4,5,1,7,6
1,0.9794563514041825,4.086987865214446,4.00302622269611,0,3,3,3,6,3
1,0.9009195358547056,4.428496651027514,3.989719147377826,1,4,5,3,7,4
1,0.9849164570148596,5.43977301461356,5.3577219645182295,2,2,4,1,5,4
1,1.1130134039045996,5.254697297748766,5.848548525855655,2,3,5,1,4,3
1,0.9398137069670724,5.5574146139210665,5.222934429462139,-3,5,2,1,6,5
1,1.0204501174065763,4.190733337402344,4.276434326171875,5,3,8,1,4,3
1,1.0693119610547601,5.548524039132254,5.93310312124399,-1,3,2,2,5,3
1,1.0813090833991517,3.7767810821533203,4.083867690142463,3,2,5,2,4,2
1,1.0519701469729579,4.918495686848958,5.1741106305803575,5,3,8,3,6,3
1,0.9590835560386338,4.490708705357143,4.306964874267578,5,5,10,1,6,5
1,1.345628646193276,3.061137859637921,4.119154793875558,1,2,3,1,3,2
1,0.9933752504059442,4.64529782249814,4.614523887634277,3,3,6,1,5,4
1,0.9480111333468667,4.5780534744262695,4.3400456628134085,11,4,15,1,5,4
1,1.0183757893792331,4.227081298828125,4.304757254464286,6,2,8,3,5,2
1,1.1793584760147666,4.08947519155649,4.822957229614258,-3,7,4,1,8,7
1,1.3549907688732727,4.23412593718498,5.737201559132543,-2,9,7,4,13,9
1,1.0670870640321577,3.249326160975865,3.467313913198618,6,2,8,1,3,2
1,1.0094762501262016,4.927370737834149,4.974063735410391,0,3,3,1,4,3
1,0.7872104911117292,5.848537098277699,4.604029761420356,-2,5,3,3,9,6
1,1.1242512555882072,4.483971659342448,5.041110768037684,2,2,4,2,5,3
1,1.0591861212486335,3.7876545299183237,4.011831110174006,0,3,3,1,4,3
1,1.2916921102095082,3.6868426983173075,4.762265625,12,8,20,1,9,8
1,0.9558215006855162,3.8966997782389323,3.7245494297572543,-1,4,3,1,5,4
1,1.0185898144302024,4.438115334024235,4.520619074503581,-1,3,2,1,4,3
1,1.1462733480881862,5.050118390251608,5.788816115435432,0,9,9,2,12,10
1,0.9510737116741556,3.335098853478065,3.171924845377604,2,2,4,1,3,2
1,1.1223508347869011,3.7572208751331675,4.2169199856844815,11,5,16,1,6,5
1,0.933653754164165,5.772717562588778,5.389719424040421,12,2,14,2,4,2
1,0.9263028321513673,6.055440902709961,5.609172058105469,0,2,2,4,6,2
1,0.9917852251146079,4.941646351533778,4.901051839192708,4,2,6,1,4,3
1,1.234660808162543,3.0099449157714844,3.716261022231158,-3,5,2,1,6,5
1,1.7069748497745048,3.72017584906684,6.35024661109561,12,5,17,1,6,5
1,1.0063728998192922,4.604612177068537,4.6339569091796875,0,4,4,2,6,4
1,0.9122231113089293,4.130513509114583,3.7679498845880683,2,2,4,1,3,2
1,0.847517356974915,4.183556747436524,3.5456369573419746,1,3,4,3,6,3
1,1.1180665334076594,5.034869194030762,5.6293187459309895,3,3,6,1,6,5
1,0.973597827027068,4.544563929239909,4.42457756629357,1,4,5,1,5,4
1,1.24501434646042,3.3528472900390627,4.174342977589574,-6,10,4,1,11,10
1,1.0040641334417857,4.848936767578125,4.8686434936523435,0,3,3,3,6,3
1,0.9691947169097006,5.608702810187089,5.435925132349918,0,2,2,1,3,2
1,1.130899695615873,3.784161703927176,4.279507319132487,-4,8,4,1,9,8
1,0.7970560226565682,5.708817618233817,4.550247464861188,0,6,6,2,8,6
1,0.9677880925085979,4.898193359375,4.740413208007812,6,3,9,1,4,3
1,1.0087075268939594,5.188241452586894,5.233418204567649,-5,7,2,1,8,7
1,1.0366321410531232,5.224870808919271,5.416269013375947,3,2,5,3,5,2
1,1.010618540246897,4.801338958740234,4.852322169712612,1,2,3,1,3,2
1,0.9979125587728127,4.923884887695312,4.913606567382812,0,2,2,3,10,7
1,0.9609579579956127,4.86761474609375,4.677573126715583,6,2,8,1,3,2
1,0.8814627354220427,5.08916255405971,4.485907145908901,0,4,4,2,6,4
1,0.9101282576719126,5.210721886676291,4.742425231933594,2,3,5,4,8,4
1,0.9975865649242708,4.059103077855603,4.049306696111506,4,3,7,4,7,3
1,0.9500785081698385,4.710188462999132,4.475048828125,-5,7,2,3,11,8
1,0.7327181088119434,2.7175979614257812,1.9912332388070912,-5,13,8,2,16,14
1,1.023065051268102,4.153851976581648,4.249660785381611,1,2,3,1,3,2
1,1.0839806901440168,5.203473227364676,5.640464500144676,-1,3,2,1,4,3
1,0.9821417373297168,5.32763706554066,5.232494723412298,9,6,15,3,10,7
1,0.9085641631671515,4.6319756141075725,4.2084470476422995,1,2,3,2,4,2
1,1.4247590994655404,3.1416947214226973,4.476158142089844,-3,5,2,1,6,5
1,1.0494166550216475,5.262542300754124,5.522599538167317,6,4,10,1,6,5
1,0.9593967438280705,3.7927433558872767,3.6387456258138022,-2,5,3,2,7,5
1,1.0047989715169083,5.622530336733218,5.649512699672154,1,4,5,7,11,4
1,1.1732736980902578,3.1668009757995605,3.7155242919921876,2,2,4,1,3,2
1,1.0195723364269347,3.231793212890625,3.2950469569156042,-1,4,3,1,5,4
1,1.1105154683169578,3.6777837844122026,4.08423578171503,0,2,2,1,3,2
1,1.158428503171727,4.2751756555893845,4.952485335500617,2,2,4,1,4,3
1,0.9770623382585463,4.3652191162109375,4.2650911966959635,-1,3,2,1,4,3
1,0.9819159372919025,5.501365661621094,5.401878620016164,21,2,23,1,3,2
1,0.9597371694591678,3.675846644810268,3.527846654256185,2,3,5,1,5,4
1,1.041918021329082,4.1428375244140625,4.316497076125372,11,2,13,1,3,2
1,1.184695056108116,3.858990805489676,4.5717273288302955,13,3,16,1,4,3
1,1.0155199328611804,3.225101124156605,3.275154477074033,-1,4,3,1,5,4
1,0.9019631406056998,4.306594212849935,3.8843892415364585,6,2,8,1,3,2
1,0.8741309627966587,5.118705749511719,4.474419185093471,-3,6,3,3,10,7
1,0.9923822148724453,5.446699919524016,5.405208129882812,-2,5,3,1,6,5
1,1.0382356593013486,4.15898292943051,4.31800438376034,-2,4,2,1,5,4
1,0.9852063553026976,3.8851483154296873,3.8276728116548977,1,2,3,2,4,2
1,1.6212872191708838,3.8671585083007813,6.269774664015997,11,4,15,1,5,4
1,0.9440180405884732,4.39672715323312,4.1505897521972654,12,2,14,3,5,2
1,0.7403130397235601,5.158845689561632,3.8191607339041576,-4,8,4,4,12,8
1,1.023573147200269,4.316221196600732,4.417968114217122,1,5,6,1,6,5
1,1.0052929333600704,5.082251485188802,5.109151503619025,4,2,6,3,5,2
1,1.0205497420622758,4.538863863263812,4.632136344909668,2,2,4,1,3,2
1,1.2054659921976896,3.3632035028366816,4.054227447509765,-1,3,2,1,7,6
1,0.9995919550911713,4.065989176432292,4.064330070249496,14,3,17,1,4,3
1,1.0154066451358552,2.8373692830403647,2.8810836247035434,4,2,6,2,4,2
1,0.8682820087515705,4.675881703694661,4.059983958368716,-1,10,9,1,13,12
1,1.0164709258227143,4.0818837483723955,4.14911615280878,3,4,7,1,5,4
1,0.9931455027790398,4.94659423828125,4.912687821821733,0,2,2,2,4,2
1,1.0764021331318983,4.633177121480306,4.987161736739309,7,2,9,1,6,5
1,1.1456524063735685,4.0490104130336215,4.638758523123605,0,2,2,1,3,2
1,1.0218373646642827,4.510654938526643,4.609155755293997,-1,3,2,1,4,3
1,0.9779940468217857,4.889176686604817,4.781585693359375,1,2,3,6,8,2
1,1.0100386623592326,3.4906724294026694,3.525714111328125,1,2,3,2,4,2
1,1.177105834504934,4.234735662286932,4.984732055664063,8,3,11,1,5,4
1,1.1332478493088127,4.005637168884277,4.539379706749549,2,3,5,1,4,3
1,0.9932603524623552,4.769172286987304,4.737029746726707,7,5,12,5,10,5
1,1.2149133997926587,3.6143178939819336,4.391083240509033,0,4,4,2,8,6
1,1.2875250412245884,4.264293193817139,5.490384270163143,1,4,5,1,6,5
1,0.8861001654949883,4.795106070382254,4.248944282531738,2,2,4,4,10,6
1,1.1340569956146755,3.223147922092014,3.6552334489493536,2,5,7,3,9,6
1,1.007380235427261,5.20107184516059,5.2394569798519735,1,5,6,6,11,5
1,0.9789406756484151,4.829234822591146,4.727534400092231,12,3,15,1,4,3
1,0.9443772056441386,4.470799372746394,4.2221210186298075,0,3,3,3,6,3
1,1.0608768807535345,4.2445039569206955,4.502896118164062,-3,9,6,2,12,10
1,1.1704789507099764,2.5734178294306216,3.012131400730299,0,7,7,5,12,7
1,1.067551934140894,5.548760775862069,5.923590298356681,0,4,4,2,7,5
1,0.9803816899071708,5.962309337797619,5.845338904339334,2,2,4,7,9,2
1,1.1171309898356045,5.4883366902669275,6.131190999348958,0,3,3,1,4,3
1,1.0465905449691304,3.506694793701172,3.6700736151801214,1,3,4,1,4,3
1,0.9949837478291362,4.612335205078125,4.5891985685929,0,3,3,8,11,3
1,1.016642019860656,4.3766350379356975,4.449471085159867,1,2,3,1,3,2
1,0.9782607846505699,4.527903123335405,4.429470062255859,0,4,4,1,5,4
1,0.9966038854818868,4.748695217833227,4.732568105061849,-1,3,2,1,4,3
1,1.009726529245326,5.760107743112664,5.816133599532278,0,2,2,1,3,2
1,1.159761505095202,4.043863101881378,4.689916757436899,3,4,7,2,6,4
1,1.2007692489391237,3.750318315294054,4.503266906738281,1,2,3,1,4,3
1,0.994821931755881,4.843512021578276,4.818431985789332,3,8,11,3,11,8
1,1.08203746217477,5.882376821417558,6.364952087402344,0,2,2,1,3,2
1,0.9555402302380173,3.577734375,3.4186691284179687,0,2,2,1,3,2
1,1.0127128178084752,5.311499532063802,5.379023657904731,3,2,5,1,3,2
1,0.9320156217655842,4.06288865033318,3.7866756916046143,-1,3,2,1,4,3
1,0.9801051948724081,3.420050048828125,3.352008819580078,3,2,5,5,12,7
1,1.0900030981738404,4.904765537806919,5.3462096320258246,-3,5,2,12,17,5
1,1.138729751398005,5.281949556790865,6.014713105701265,8,2,10,1,3,2
1,0.9488951564458539,5.034857529860276,4.777551923479352,1,2,3,2,4,2
1,0.8907226478280623,4.806671505882626,4.281411170959473,3,3,6,2,7,5
1,1.0439177476661496,4.834351806640625,5.046665649414063,0,2,2,1,3,2
1,0.9884610523004991,3.701390233533136,3.6586800852129535,2,2,4,1,4,3
1,0.9408921012640361,4.379418267144097,4.120560055687314,3,2,5,1,4,3
1,1.065707766440484,5.296118277090567,5.644114379882812,-2,4,2,4,7,3
1,0.9575905929453242,4.515751471886268,4.324241129557292,2,3,5,2,5,3
1,1.1846711677853827,3.6325254440307617,4.303348159790039,-4,11,7,1,14,13
1,1.0220548728864163,4.461155778270657,4.559546001886917,0,3,3,1,4,3
1,0.9612644393576533,5.808444431849888,5.5834510803222654,12,3,15,1,9,8
1,2.023487748938074,2.4447910308837892,4.947004699707032,5,2,7,1,3,2
1,1.0439945108463402,4.538313293457032,4.737974166870117,2,3,5,2,6,4
1,0.7687604825084438,4.5123982429504395,3.4689534505208335,2,3,5,1,4,3
1,0.9848688696504542,4.430264663696289,4.363229751586914,1,3,4,1,4,3
1,0.9796321879357867,4.373442909934304,4.284365446671195,1,2,3,1,3,2
1,0.8697036499293104,4.231812976655506,3.6804231916155135,0,3,3,5,8,3
1,0.9730222973138518,5.2161916097005205,5.0754707433000394,1,4,5,3,7,4
1,0.7480648928178677,4.8281675974528,3.6117826762952303,7,6,13,1,7,6
1,1.068111533761838,4.7882741292317705,5.114410824245876,9,3,12,2,5,3
1,1.0571293271372475,4.357589017427885,4.606535145934199,6,8,14,2,10,8
1,0.9055045306360383,5.3097588323777725,4.808010679302794,2,3,5,2,5,3
1,1.0963947568014356,3.5672197341918945,3.9110810129266036,3,3,6,2,5,3
1,1.0535432579967492,4.3248146186440675,4.556379283558239,-4,12,8,1,15,14
1,1.0013601641709111,3.4168270111083983,3.4214744567871094,0,4,4,4,8,4
1,0.8520573796423081,5.407477985728871,4.607481522993608,0,7,7,1,8,7
1,1.004359801780237,4.763082716200087,4.7838488127055925,2,4,6,4,8,4
1,1.0179358053880099,3.778823440139358,3.846599681957348,0,3,3,1,4,3
1,1.074405746065596,5.711178302764893,6.1361227852957585,3,4,7,1,6,5
1,0.9767058035804098,4.7962345796472885,4.684510149274554,1,2,3,1,3,2
1,1.0369914833966962,4.984531568444294,5.168916785198709,0,3,3,4,7,3
1,1.1063360738516879,5.156209160299862,5.704500198364258,-1,3,2,1,4,3
1,1.178998026806447,3.7838575575086804,4.461160594019397,2,5,7,1,6,5
1,0.9202985997934403,3.1099726359049478,2.8621034622192383,3,2,5,1,3,2
1,1.0719865991585302,4.388884911170373,4.704825810023716,2,3,5,6,9,3
1,0.9953479050752448,4.384297688802083,4.363901519775391,-1,4,3,2,6,4
1,1.1150393849886675,4.137688318888347,4.613685438368056,21,4,25,1,5,4
1,1.1125712613838081,3.2758498191833496,3.6446163654327393,0,2,2,1,3,2
1,0.9786238613541226,6.780557485727163,6.635615348815918,3,2,5,1,3,2
1,1.1038945140154075,4.372249857584635,4.826502631692326,2,2,4,1,3,2
1,0.9476593173803294,4.9628753662109375,4.703115081787109,2,2,4,1,3,2
1,1.0219877630911962,4.596799935867537,4.697873283835018,1,5,6,6,11,5
1,1.0502553857299872,3.8999122619628905,4.095903857000943,-1,3,2,2,5,3
1,0.9159610880679453,4.584253664369936,4.198997974395752,5,2,7,2,4,2
1,0.9012757449690864,5.375711822509766,4.844998677571614,-1,3,2,4,8,4
1,0.9286466392752014,4.190046946207683,3.8910730150010853,0,3,3,2,5,3
1,1.208231417788575,3.495178916237571,4.222984977390455,12,4,16,1,5,4
1,0.8302619859442962,4.092142441693475,3.397550310407366,4,3,7,1,4,3
1,0.9906605035420484,4.453746795654297,4.41215104323167,-3,5,2,1,6,5
1,0.9894161128815125,5.1054026285807295,5.051367623465402,0,2,2,3,5,2
1,1.1282402942053815,3.8195377696644175,4.309356416974749,3,3,6,1,5,4
1,1.0965742687851723,4.292006356375558,4.706503731863839,7,2,9,1,3,2
1,0.9589523980669669,3.925504635541867,3.764372083875868,-3,6,3,5,11,6
1,0.9643244311010716,3.522382354736328,3.3967193603515624,0,2,2,1,3,2
1,0.9996139102643099,5.314002365362449,5.31195068359375,2,4,6,1,5,4
1,1.0342964705058397,4.54741749010588,4.703377859933036,1,2,3,1,3,2
1,0.9931703466844324,4.153185526529948,4.124820709228516,0,3,3,1,4,3
1,0.9123788503789416,5.340802793149595,4.872835512514468,0,3,3,1,4,3
1,0.8302151224317931,3.72555424616887,3.093011474609375,2,3,5,1,4,3
1,1.0038790627488274,6.2885798136393225,6.31297360933744,-2,4,2,1,5,4
1,0.9904407879679252,4.776743035567434,4.731081136067709,3,2,5,1,3,2
1,1.0414718410698056,3.7055267333984374,3.859201749165853,-1,3,2,4,7,3
1,1.1131827050322471,4.446407953898112,4.9496644337972,0,4,4,3,7,4
1,1.0179734940566323,4.852578440020161,4.939796229771205,4,3,7,1,4,3
1,0.7559265236551969,3.32864726673473,2.5162127568171573,2,4,6,1,5,4
1,1.0580350604540618,4.95169194539388,5.2390636867947045,0,2,2,1,3,2
1,0.7016705025201888,5.290959444912997,3.712510172526042,4,5,9,1,6,5
1,0.9671449361373363,3.6745696196684965,3.553841400146484,3,2,5,8,10,2
1,1.024276564685206,3.7277198791503907,3.8182161119249134,-3,5,2,1,6,5
1,0.9724407518346857,3.420710476962003,3.3264382680257163,1,3,4,1,6,5
1,0.962583330574956,4.852455540707237,4.670892815840872,0,5,5,3,8,5
0,0.9863119986860733,4.35133056640625,4.291769547895952,1,2,3,4,4,-3
0,1.135263671243153,4.199172549777561,4.767168045043945,-2,5,3,6,6,-4
0,1.0889819934570228,4.82379150390625,5.253022087944879,7,3,10,12,12,-10
0,0.9622559496327132,5.05151596069336,4.860851287841797,0,2,2,4,4,-2
0,0.9296131361614,3.4964319864908853,3.250329104336825,-1,6,5,8,8,-7
0,1.0724981693948572,4.285925431685015,4.596647179645041,1,7,8,9,9,-8
0,0.9947736123874388,4.11099370320638,4.089508056640625,-3,5,2,3,3,-2
0,0.9367624395004363,4.550580641802619,4.262813023158482,-3,5,2,4,4,-3
0,1.109759842981169,3.2819281357985277,3.642152052659255,0,5,5,6,6,-5
0,0.9448072600378895,3.7958406147203947,3.5863377707345143,-5,9,4,5,5,-4
0,0.96528274361807,5.100239054361979,4.923172747502561,1,2,3,4,4,-3
0,1.2133846706050542,3.5464436457707333,4.303200354942908,0,4,4,5,5,-4
0,0.8112868071330595,3.583243476019965,2.9070381588406033,0,3,3,5,5,-3
0,1.2579621572390325,2.872003443100873,3.6128716468811035,-1,7,6,7,7,-6
0,1.0152939277282476,4.983412848578559,5.059628804524739,0,2,2,3,3,-2
0,1.0424099939092106,4.115735473632813,4.290283790001502,1,3,4,5,5,-4
0,0.8923229377786435,5.696536344640395,5.0831500462123325,-3,9,6,8,8,-7
0,1.0194552140180746,4.295309240167791,4.378875400709069,1,3,4,6,6,-4
0,0.9029660916231723,4.806440602178159,4.340052885167739,-6,11,5,9,9,-6
0,1.0441901678087908,5.466775720769709,5.708353457243546,1,3,4,9,9,-4
0,1.2609010798614575,3.774529890580611,4.759308815002441,-3,5,2,4,4,-2
0,0.8374679652245116,6.410325186593192,5.368441990443638,0,3,3,4,4,-3
0,1.0584760248882414,5.165722094084087,5.467792987823486,-6,8,2,4,4,-3
0,0.9673718659098326,3.7456490652901784,3.6234355253331803,-1,3,2,3,3,-2
0,0.7837936728523377,5.321891197791467,4.1712646484375,0,4,4,5,5,-4
0,0.9543056055918427,3.945348358154297,3.7650680541992188,1,3,4,15,15,-12
0,0.979208965684957,4.633279837814032,4.536949157714844,-1,4,3,5,5,-4
0,1.061112028078538,4.785241989862351,5.077677832709418,-3,7,4,7,7,-4
0,1.0172345422720674,4.34390141413762,4.418766566685268,1,3,4,10,10,-5
0,0.937236504675029,4.774563789367676,4.474895477294922,0,4,4,6,6,-5
0,0.5555344315260071,6.259467569986979,3.4773497581481934,-14,25,11,13,13,-12
0,2.182422518323499,3.36445060143104,7.342652754350142,-2,8,6,7,7,-5
0,0.9573012231445654,3.69952392578125,3.541558779202975,0,3,3,4,4,-3
0,0.9553681733986759,4.916817135281033,4.69737060546875,7,3,10,5,5,-4
0,1.0124904647140383,4.518023681640625,4.574455897013347,2,3,5,10,10,-5
0,0.9564687164953544,4.465441473599138,4.2710550748384914,-3,7,4,5,5,-4
0,0.8860638490481435,4.73011589050293,4.191184692382812,5,2,7,8,8,-7
0,0.987425532055497,4.6180267333984375,4.559957504272461,-10,13,3,5,5,-3
0,1.009565451397623,3.9092542860243054,3.9466480678982205,0,3,3,4,4,-3
0,1.010957216797502,4.7387273879278276,4.790650651261613,-5,10,5,6,6,-5
0,1.0041383499426004,5.218249130249023,5.239844071237664,-2,4,2,3,3,-2
0,1.0376969854783966,5.033305358886719,5.223045797909007,-6,9,3,6,6,-3
0,1.28216579808152,4.8692827224731445,6.243227767944336,-4,13,9,10,10,-9
0,1.037596596118916,4.750133938259548,4.928722805447048,0,3,3,4,4,-3
0,1.049621659993802,6.076289653778076,6.377805233001709,0,2,2,4,4,-2
0,0.8533462540161683,4.693817615509033,4.005451679229736,0,3,3,4,4,-3
0,0.9483648653927287,3.528697204589844,3.3464924494425454,4,5,9,10,10,-9
0,0.9800879248261942,4.628935440726902,4.536763730256454,0,4,4,5,5,-4
0,0.759971286725363,4.466579437255859,3.394472122192383,1,2,3,4,4,-3
0,0.9453026969824906,3.860298919677734,3.649150979929957,-1,8,7,11,11,-7
0,0.9528674996751499,3.9962911191193955,3.8079359266493054,-5,8,3,11,11,-6
0,1.0251100865327996,3.722071493825605,3.8155330311168325,2,2,4,5,5,-4
0,1.296156536620897,3.073360633850098,3.983556474958147,-3,6,3,5,5,-3
0,1.044832670782095,4.267112368629093,4.458418412642046,-10,13,3,4,4,-3
0,1.0240296654653014,3.555833725702195,3.6412792205810547,-1,6,5,9,9,-6
0,1.0486993480192413,3.718054337935014,3.899121160092561,1,3,4,9,9,-8
0,1.1714323352342522,4.387223137749566,5.139335045447717,4,4,8,12,12,-10
0,0.9279300270585574,5.469455718994141,5.075272193321815,-3,8,5,6,6,-5
0,0.8630988151489577,5.016613642374675,4.329833290793679,-13,15,2,3,3,-2
0,0.6646846158860572,4.640204036937041,3.084272237924429,-4,9,5,8,8,-7
0,1.0077125893724725,5.0416924261277725,5.080576929552802,-4,6,2,3,3,-2
0,0.9854978555445407,4.766088213239398,4.696969713483538,0,4,4,5,5,-3
0,1.118139592713496,4.10979870387486,4.595328648885091,-2,4,2,4,4,-2
0,0.9357006505668645,4.69129140753495,4.389644422029194,0,2,2,6,6,-2
0,1.0649151476769114,3.3728400336371527,3.5917884425113074,1,3,4,5,5,-4
0,0.9684134224204094,4.025433785574776,3.8982841090152136,3,3,6,8,8,-6
0,0.9666907391141799,4.014695167541504,3.8809686388288225,-1,3,2,3,3,-2
0,0.9885642649282523,5.088201669546274,5.030014343261719,-1,3,2,7,7,-2
0,0.8938097764773545,4.046961697665128,3.617213930402483,3,2,5,6,6,-5
0,0.952366895331308,4.562542127526325,4.345214080810547,-3,9,6,9,9,-6
0,0.9755912193411775,5.3362681070963545,5.20601630933357,0,4,4,11,11,-10
0,0.944897258898604,5.195883009168837,4.909575612921464,1,6,7,10,10,-9
0,1.0100728812318742,4.561517987932477,4.607465616861979,1,3,4,7,7,-4
0,1.065160502363383,4.0225647820366754,4.284677124023437,-1,3,2,3,3,-2
0,0.8503098405001417,4.311378479003906,3.6660075468175553,1,3,4,5,5,-4
0,0.9512482890191643,4.608827209472656,4.384138997395834,0,3,3,4,4,-3
0,0.862650322472646,4.747071210075827,4.095062510172526,-2,4,2,4,4,-2
0,1.0043901604879217,2.830010732014974,2.842434933311061,1,2,3,4,4,-3
0,0.8526973570246473,5.197094387478298,4.431548648410374,-9,11,2,14,14,-2
0,0.8514133116591096,5.865996727576623,4.994387700007512,0,4,4,14,14,-12
0,1.012865254802723,5.212334576775046,5.279392589222301,-6,8,2,4,4,-3
0,0.9864460270872735,4.233150188739483,4.175774185745804,1,2,3,6,6,-3
0,1.011226955784393,5.013067626953125,5.0693491155451,-3,5,2,3,3,-2
0,1.0064491554836656,4.198087692260742,4.225161812522194,-6,9,3,4,4,-3
0,0.884026779641078,5.058601379394531,4.4719390869140625,-4,6,2,4,4,-3
0,0.8049853648692927,4.991598690257353,4.018163892957899,1,5,6,11,11,-7
0,0.8929494698946112,4.348297729492187,3.8828101524939904,1,3,4,6,6,-4
0,0.9404866355935635,5.414170698686079,5.091955184936523,-2,8,6,12,12,-8
0,1.0817684694156369,3.6484515850360575,3.9467798868815103,-1,3,2,8,8,-5
0,1.0606400849949225,4.553311983744304,4.829425209446957,-5,10,5,11,11,-5
0,0.9217245752207058,4.988119506835938,4.597672333588472,-3,5,2,3,3,-2
0,0.8058444532403659,4.466678873697917,3.599448394775391,-5,8,3,7,7,-2
0,0.9592752429197571,5.089300876193576,4.882040334302325,-2,4,2,3,3,-2
0,0.8430218190582962,4.772082374209449,4.022969563802083,-3,9,6,11,11,-6
0,1.0153674120754086,3.5435638427734375,3.5980192485608553,-4,6,2,3,3,-2
0,0.9852470381434639,5.121547992412861,5.045989990234375,0,3,3,4,4,-3
0,1.0646941414878635,4.740796319369612,5.047498067220052,-5,8,3,5,5,-3
0,0.7788076490733409,3.7208692762586804,2.897841453552246,-1,3,2,4,4,-2
0,0.9572147964066122,5.22223641531808,4.9988019670758925,0,4,4,6,6,-4
0,1.0036171021097366,4.223873138427734,4.239151318868001,0,5,5,7,7,-6
0,1.1556158822187523,4.211329345703125,4.866679077148437,0,5,5,6,6,-5
0,0.9370914161832836,4.060081481933594,3.8046675057246766,1,3,4,5,5,-4
0,0.747424129575573,5.8484135945638025,4.371245440314798,2,3,5,7,7,-6
0,1.00813748374103,4.561628168279475,4.598748343331473,-2,4,2,3,3,-2
0,0.9524645527836977,5.037549336751302,4.798087176154642,-2,5,3,4,4,-3
0,1.0700403577245838,4.849035314611487,5.188663482666016,-15,17,2,3,3,-2
0,0.9701268553959496,6.697846152565696,6.497760425914418,0,2,2,4,4,-2
0,0.8984520425474929,4.724564870198567,4.2447949577780335,-1,4,3,7,7,-3
0,0.9515034847902354,4.172884160822088,3.9705138206481934,-6,8,2,3,3,-2
0,1.1353396703174317,4.666800498962402,5.298403739929199,0,7,7,11,11,-8
0,1.0128637016326711,5.7467031905900186,5.820627065805288,-4,6,2,3,3,-2
0,0.8731551290358113,3.8421060898724724,3.354754638671875,-2,5,3,7,7,-3
0,0.9846560135682344,4.862852616743608,4.788237072172619,-1,3,2,8,8,-2
0,0.943918729712697,3.909712704745206,3.6904510498046874,-2,5,3,6,6,-5
0,0.8453191583332227,4.879579671223959,4.12480218069894,-1,4,3,5,5,-4
0,1.1505368670809748,4.226224837764617,4.862427484421503,-10,14,4,5,5,-4
0,0.8757806191593727,5.631222152709961,4.931715223524305,-1,3,2,3,3,-2
0,0.9622179651231041,4.285912831624349,4.123982323540582,0,2,2,3,3,-2
0,1.0314203333400338,2.878169377644857,2.968602418899536,-1,3,2,3,3,-2
0,0.8963315740451476,3.4536198634727326,3.095588528380102,-2,4,2,3,3,-2
0,1.2381889797753967,2.868877584284002,3.552212609185113,-2,4,2,3,3,-2
0,1.0667636187865523,4.227042061941964,4.50925468676018,-2,5,3,6,6,-3
0,1.1022082481827422,3.020227704729353,3.3289198875427246,-3,5,2,6,6,-5
0,1.1163316641966334,3.193550522262986,3.565061569213867,3,5,8,12,12,-10
0,1.042681116565371,5.972177028656006,6.2270762125651045,-1,4,3,5,5,-4
0,1.0561253089460996,4.1130833943684895,4.343931470598493,-1,3,2,3,3,-2
0,0.9298738337382999,5.149697113037109,4.788568597090872,-2,5,3,4,4,-3
0,1.040442864892284,4.449988810221354,4.6299591064453125,0,4,4,6,6,-5
0,1.13189893376909,4.632139646089994,5.243113926478794,1,2,3,6,6,-3
0,0.9774151003258229,4.485570907592773,4.384264738663383,-1,3,2,3,3,-2
0,1.0148318438870525,5.051839688929116,5.126767786537728,0,3,3,5,5,-3
0,0.9739875505312141,4.683370552810968,4.561544612962372,-2,4,2,5,5,-2
0,1.0861022771509874,4.183322058783637,4.543515614100865,-4,6,2,3,3,-2
0,0.6604869958482242,4.881686619349888,3.2242905298868814,-1,3,2,3,3,-2
0,0.9782739337968556,3.597046407063802,3.518896738688151,-3,5,2,3,3,-2
0,1.0132258010354869,3.6636109352111816,3.7120651245117187,-2,4,2,4,4,-2
0,0.8580613061379828,4.695095683253089,4.02867993441495,-21,26,5,7,7,-6
0,0.7895338435171814,4.477415427183494,3.535071011247306,-10,15,5,6,6,-5
0,0.9990347642702747,4.350261688232422,4.346062660217285,-2,4,2,8,8,-4
0,1.0257578360897193,5.014996696920956,5.144172159830729,-2,4,2,4,4,-2
0,1.000701721678538,3.8215907170222354,3.8242724100748697,-9,12,3,4,4,-3
0,0.8996332635036706,2.9171676635742188,2.6243810653686523,-4,6,2,4,4,-2
0,0.9492349435052292,5.24005606515067,4.974044322967529,-3,6,3,4,4,-3
0,0.9445304152471236,4.905636180530895,4.633522578648159,3,2,5,7,7,-6
0,1.016411219901793,4.925785125248016,5.006623268127441,1,3,4,5,5,-4
0,0.8299682192504735,3.2483577728271484,2.6960337162017822,-2,5,3,4,4,-3
0,0.9896634990292723,4.787884712219238,4.738394737243652,0,7,7,9,9,-8
0,1.1061915782906768,4.225255966186523,4.673942565917969,-11,15,4,7,7,-6
0,1.0423902540131054,4.59348201751709,4.788200887044271,-2,6,4,6,6,-4
0,1.1536062942465988,3.5408791934742645,4.084780524758732,0,6,6,7,7,-6
0,0.8330822896152026,3.8698436192103793,3.2238981827445654,2,4,6,7,7,-6
0,0.8992644530653026,4.847735404968262,4.359396127554087,-6,9,3,7,7,-3
0,0.9580621519293832,4.541713127723107,4.351243452592329,-4,6,2,3,3,-2
0,1.011046437538621,5.591628786117312,5.653396364242312,0,6,6,8,8,-7
0,0.9937428590368363,4.196737501356337,4.170477923224954,-2,4,2,3,3,-2
0,0.8732049086817958,5.156467692057292,4.502652900163517,-17,19,2,3,3,-2
0,1.1615850730621415,3.6724510192871094,4.265864285555753,0,7,7,10,10,-7
0,0.8073974989043378,4.776536794809195,3.8565638615534854,0,3,3,5,5,-3
0,0.8239458832142595,4.382484436035156,3.610930009321733,0,2,2,3,3,-2
0,0.9028504574836794,4.0900198800223215,3.6926763197954964,-1,4,3,4,4,-3
0,1.090771131850907,4.4384662083217075,4.841350809733073,1,2,3,4,4,-3
0,1.021300979425921,2.9138364791870117,2.9759040500806724,-9,12,3,8,8,-3
0,0.9928979436503833,4.9082997639973955,4.873440742492676,-1,3,2,3,3,-2
0,0.5762994241485848,5.582289123535157,3.2170700073242187,0,3,3,6,6,-5
0,0.9907746274648536,5.436299523641897,5.386147635323661,-1,4,3,4,4,-3
0,0.9657214062489953,5.30341552734375,5.1216219009891635,6,3,9,13,13,-9
0,1.003511757534309,4.336130339523842,4.351357777913411,-5,9,4,5,5,-4
0,0.956943319610578,4.865634918212891,4.656136830647786,-2,5,3,4,4,-3
0,1.1095734677801459,4.200817108154297,4.6611152062049275,0,3,3,4,4,-3
0,1.073154290963794,4.309478066184304,4.624734878540039,-6,8,2,3,3,-2
0,0.8743039139851212,6.100958251953125,5.33409167874244,-29,57,28,32,32,-31
0,0.94666050407301,5.260883649190267,4.980270767211914,-2,5,3,5,5,-3
0,0.9185351696587302,4.873390197753906,4.476380292107077,0,3,3,5,5,-3
0,1.0231397479057387,3.045320510864258,3.115788459777832,0,6,6,7,7,-6
0,1.0428009562346303,4.289133453369141,4.4727124665912825,-1,4,3,4,4,-3
0,1.0259678247592605,4.482214554496434,4.598607916581003,-4,7,3,4,4,-3
0,1.0412611824099094,4.17144801698882,4.34356689453125,1,2,3,4,4,-3
0,0.9062204487573898,3.8973191359947466,3.5318302963719224,4,3,7,8,8,-7
0,1.0104746961803426,5.090275065104167,5.143594149885507,-1,4,3,6,6,-3
0,0.9206373106248843,4.831561817842371,4.448116078096278,0,6,6,13,13,-11
0,1.0917606912472266,3.9930663108825684,4.359472835765166,1,2,3,4,4,-3
0,0.913334078513996,4.8355873107910154,4.416506680575284,1,2,3,5,5,-3
0,1.0662854564250481,3.8864851731520433,4.144102616743608,-2,5,3,4,4,-3
0,1.0183031653446009,5.35728417373285,5.455339431762695,-1,3,2,3,3,-2
0,1.0301428707573785,4.430992853073847,4.5645556979709205,-3,6,3,4,4,-3
0,1.0067918076970044,4.751256482354526,4.783526102701823,-5,7,2,3,3,-2
0,1.0063287232274742,4.4309547424316404,4.4589970286299545,1,3,4,5,5,-4
0,1.1085123836870319,3.679028159693668,4.078248274953742,0,6,6,7,7,-6
0,1.0826838112920858,4.403899129231771,4.7680302937825525,0,3,3,5,5,-3
0,0.6283467938735747,5.172967764047476,3.250417709350586,-6,8,2,3,3,-2
0,0.8392553821301159,4.887599720674403,4.101944371273643,2,5,7,11,11,-10
0,1.2234915985756525,4.799346923828125,5.871960639953613,0,2,2,5,5,-4
0,0.7722887674200565,4.767339433942523,3.6817626953125,-34,36,2,4,4,-3
0,0.8985298039430433,4.160134566457648,3.738004896375868,-1,3,2,3,3,-2
0,0.9970936478338757,4.4432435647035255,4.430329934144631,0,2,2,3,3,-2
0,0.9812576852108466,4.5028183395798145,4.418425100821036,-10,14,4,6,6,-4
0,0.9584542131337118,3.932201385498047,3.768834984820822,-5,8,3,5,5,-3
0,0.9903806690912144,4.9120855712890625,4.864834594726562,20,3,23,8,8,-7
0,0.82154260729148,4.592922973632812,3.773281914847238,-1,3,2,3,3,-2
0,1.0483433529247936,4.099689852806829,4.297882606243265,-2,5,3,8,8,-7
0,0.8591590562678801,4.8010741339789496,4.124886322021484,1,2,3,4,4,-3
0,1.079227161955781,4.685879937533675,5.05712890625,6,2,8,11,11,-8
0,1.1041314905359654,4.593033447265625,5.0713128662109375,0,3,3,4,4,-3
0,0.8506105030984871,4.093650309244792,3.4821019490559895,0,3,3,4,4,-3
0,1.0761377462268342,3.895966339111328,4.192596435546875,-12,14,2,4,4,-3
0,0.9683756882848064,4.197970954739318,4.065213012695312,1,2,3,12,12,-9
0,0.9157185332853955,4.136030717329546,3.787439982096354,-4,6,2,3,3,-2
0,0.9404188104380855,5.388147881690492,5.067115621363863,0,3,3,4,4,-3
0,0.9990193982048481,5.567937490102407,5.56247756060432,-3,8,5,7,7,-5
0,0.9596268072175888,3.9144394818474266,3.7564010620117188,1,3,4,5,5,-4
0,0.9329539327761202,4.535266876220703,4.231195068359375,1,3,4,5,5,-4
0,1.0146347838512875,3.645382775200738,3.698732164171007,0,3,3,6,6,-3
0,0.8069602976344714,4.8100084902635265,3.8814858829273895,-50,52,2,3,3,-2
0,0.9790859780994406,3.9087350027901784,3.8269876333383412,-1,4,3,5,5,-3
0,0.9772586181660862,5.2140184190538195,5.095444435297057,-2,4,2,3,3,-2
0,1.1198550271165062,3.6656010945638022,4.104941813151042,-3,6,3,4,4,-3
0,0.984612148243867,5.233522740806022,5.152990068708148,1,2,3,9,9,-3
0,0.9496243298604337,4.122747421264648,3.915061257102273,3,3,6,7,7,-6
0,1.1881367382536447,3.7275653415256076,4.428857326507568,-2,5,3,5,5,-3
0,0.9613700018882804,5.294064429498488,5.0895547305836395,3,4,7,8,8,-7
0,0.9448632095654613,5.043406459263393,4.765329214242788,4,3,7,8,8,-7
0,0.8723776175002248,4.778486552991365,4.168644714355469,1,2,3,4,4,-3
0,0.9122208595139404,4.815555967133621,4.392850603376116,-1,3,2,3,3,-2
0,0.916138427674425,4.64854020338792,4.258706312913161,0,2,2,3,3,-2
0,1.1696126583893354,5.235535317278923,6.123548380533854,13,4,17,48,48,-28
0,1.000807295483255,4.487509464872057,4.491132210994112,0,3,3,4,4,-3
0,1.0169978665090198,5.267336810076678,5.356870298032407,0,2,2,6,6,-5
0,0.9673863243024687,4.87978860606318,4.720640762992527,0,2,2,4,4,-2
0,1.0090238897196468,5.122226990375323,5.168449401855469,-5,7,2,3,3,-2
0,0.9222039406741153,5.473483276367188,5.047667846679688,-10,13,3,4,4,-3
0,0.8552277827052948,4.890515414151278,4.182504653930664,-1,5,4,7,7,-4
0,0.9648153102717352,5.0427536502961186,4.865325927734375,-1,3,2,6,6,-2
0,1.0064491554836656,4.198087692260742,4.225161812522194,-6,9,3,4,4,-3
0,0.968901987935172,4.389010111490886,4.25252062209109,-1,4,3,7,7,-6
0,0.9778367645228024,4.703862683526401,4.5996098672190024,2,2,4,5,5,-4
0,0.9890234284635556,4.854423229510967,4.801138305664063,-1,3,2,3,3,-2
0,1.0233249443196275,4.668682098388672,4.77757884837963,5,3,8,10,10,-9
0,1.0008079820766014,5.317088317871094,5.321384429931641,0,3,3,4,4,-3
0,1.042807436905276,4.473024291992187,4.66450299714741,-6,10,4,5,5,-4
0,0.9922335848137813,5.480618068150112,5.438053312755766,0,3,3,4,4,-3
0,0.8364541067867732,4.510902404785156,3.773162841796875,-3,6,3,4,4,-3
0,0.994198166549197,4.6882071244089225,4.661006927490234,-2,4,2,3,3,-2
0,1.0448978583409914,3.881564827852471,4.055838775634766,-3,5,2,3,3,-2
0,0.7704873046241937,4.692284293796705,3.6153454780578613,-7,9,2,5,5,-4
0,1.0371569264659333,5.186802164713542,5.379527791341146,0,2,2,5,5,-2
0,1.0148118531277004,4.904896418253581,4.977547023607337,-1,3,2,3,3,-2
0,0.9250687098427136,5.814220428466797,5.37855339050293,-8,12,4,6,6,-4
0,1.0750661905246044,4.415873014009916,4.747355779012044,-2,4,2,4,4,-2
0,1.0648303281879437,3.882979736328125,4.134714586981412,4,4,8,9,9,-8
0,0.9749150271076439,4.425338158240685,4.314328670501709,3,2,5,6,6,-5
0,0.9805465873851991,4.1035096703506095,4.023682403564453,-2,4,2,3,3,-2
0,0.8982677087273776,4.818545532226563,4.328343854631696,-5,8,3,4,4,-3
0,1.0287876399997404,5.584392070770264,5.745153539321002,1,2,3,6,6,-3
0,1.1236069088527325,4.488433837890625,5.043235270182292,-2,4,2,3,3,-2
0,1.1799984373948587,3.519144204946665,4.152584662804236,0,3,3,4,4,-3
0,1.0189411442502823,3.976652145385742,4.051974487304688,0,2,2,4,4,-2
0,1.0354925155799946,3.6842161814371743,3.814978281656901,0,2,2,3,3,-2
0,0.9747126288378053,4.933181338840061,4.8084341513144,1,5,6,8,8,-6
0,1.028857273883874,4.336028035481771,4.461153984069824,-7,10,3,4,4,-3
0,1.0020615950262572,4.523981094360352,4.533307711283366,0,3,3,8,8,-3
0,1.2601424145451667,3.9817340557391825,5.017551967075893,1,3,4,6,6,-4
0,0.8868944295091614,4.757816314697266,4.2196807861328125,-7,10,3,4,4,-3
0,0.830877556637899,5.387558937072754,4.4764018058776855,0,2,2,3,3,-2
0,0.9898925892287951,5.1254627227783205,5.073657565646702,-4,6,2,4,4,-2
0,1.0111861377844125,4.762368679046631,4.8156411912706165,-7,10,3,6,6,-3
0,1.0523697695512197,5.379915509905134,5.661660445363898,-2,7,5,8,8,-5
0,0.9944356247307613,4.260659354073661,4.236951446533203,1,2,3,4,4,-3
0,0.9593100594410272,5.762377999045632,5.527907180786133,-2,4,2,10,10,-2
0,1.0130686839001684,5.0502065022786455,5.1162060546875,-2,4,2,5,5,-4
0,0.774988358480477,4.48449472280649,3.475431203842163,-10,12,2,3,3,-2
0,0.8517041318510067,5.061047024197048,4.310514662000868,9,4,13,11,11,-10
0,0.8861455756531584,5.047692242790671,4.472990148207721,0,4,4,10,10,-9
0,0.780502541642479,3.637029520670573,2.8387107849121094,-2,9,7,8,8,-7
0,1.1069067568799074,3.2775982943448154,3.6279956983483355,1,3,4,5,5,-4
0,0.9308505684970071,4.392081550929857,4.088371608568274,0,3,3,4,4,-3
0,0.9791195669187004,4.696355405061142,4.598293470299763,0,2,2,7,7,-2
0,1.0108149647774873,5.032759602864584,5.087188720703125,-1,3,2,3,3,-2
0,0.9590156273247916,4.409857401033727,4.229122161865234,-5,7,2,4,4,-2
0,1.2423288062778015,3.4483436584472655,4.283976660834418,-1,4,3,4,4,-3
0,0.6096069454919307,4.274234274159307,2.6056029001871743,1,9,10,12,12,-11
0,0.9077018891646261,5.665929794311523,5.142975178170712,-1,7,6,7,7,-6
0,1.0482910627602662,4.308797624376085,4.516874040876116,-22,25,3,5,5,-4
0,0.9787978435341222,4.631962320078975,4.53375473022461,-3,5,2,3,3,-2
0,1.0432462376322864,4.1960452270507815,4.3775083960556405,-9,11,2,3,3,-2
0,1.0917263040123129,3.8112169901529946,4.160805838448661,3,4,7,11,11,-8
0,1.00205640473976,4.658313526826746,4.667892904842601,0,3,3,9,9,-3
0,0.8338440510009167,4.356292377818715,3.632468483664773,0,2,2,4,4,-2
0,0.9588319055582057,2.719875717163086,2.607903616768973,-3,6,3,4,4,-3
0,1.000026431561338,3.094233879676232,3.094315665108817,2,3,5,9,9,-5
0,1.0241443937401695,4.928901163736979,5.047906494140625,0,3,3,4,4,-3
0,1.2119071704187738,3.9432551066080728,4.7788591384887695,-1,3,2,3,3,-2
0,0.9727296441183524,5.675914287567139,5.521130084991455,0,3,3,4,4,-3
0,0.6229696175846839,4.561565144856771,2.8417164938790456,-8,10,2,4,4,-2
0,1.0946695392089096,3.7792724609375,4.137054443359375,1,3,4,5,5,-4
0,1.0592053767992597,4.523929302509014,4.7917702414772725,-2,4,2,3,3,-2
0,0.6648927466279632,4.102979532877604,2.728041330973307,-6,11,5,12,12,-11
0,0.9648453212384767,4.928259658813476,4.755008273654514,-1,3,2,3,3,-2
0,1.037545641140795,4.539242553710937,4.709671325683594,0,2,2,3,3,-2
0,0.7054007136789688,2.3165141211615667,1.6340707143147786,3,2,5,9,9,-5
0,0.9812463361653365,4.230645751953125,4.151305643717448,0,3,3,7,7,-3
0,0.9091614728814342,3.8366406758626304,3.488125887784091,-1,3,2,3,3,-2
0,0.6411868506635382,4.548689189710115,2.9165596961975098,-30,32,2,3,3,-2
0,0.962692549379513,5.048136138916016,4.859803049187911,-1,5,4,7,7,-4
0,1.1112083313309795,4.468341064453125,4.96525781804865,1,2,3,4,4,-3
0,0.9502956262972773,4.3835310759367765,4.165650409200917,-4,6,2,5,5,-2
0,0.8666065978039785,4.265780398720189,3.696753438313802,-4,7,3,4,4,-3
0,0.9310499618589759,4.1291178189791164,3.844414987871724,5,4,9,14,14,-9
0,0.9990261715366966,4.74155009876598,4.736932642319623,-10,18,8,9,9,-8
0,1.020320517671125,4.863517895079496,4.962347096410291,1,5,6,9,9,-6
0,0.5362598729898382,4.50364885832134,2.415126164754232,-7,13,6,7,7,-6
0,0.9507825652407819,5.110922677176339,4.859376173753005,-1,3,2,6,6,-2
0,0.9387878084179,5.359816158519072,5.031730064978967,-4,6,2,3,3,-2
0,0.8631157489177649,4.058154602050781,3.5026571485731335,-7,9,2,3,3,-2
0,0.9416517329753097,4.865028018043155,4.581162064163773,-9,11,2,3,3,-2
0,1.4959758780671408,3.237799326578776,4.843669690583882,7,2,9,10,10,-9
0,0.8883984135356794,4.590483665466309,4.078178405761719,-6,9,3,4,4,-3
0,1.376957294567459,3.2361791133880615,4.456080436706543,0,2,2,5,5,-2
0,0.8877001981423949,4.62897889510445,4.109145482381185,1,3,4,16,16,-12
0,1.042545395372583,5.0578070068359375,5.272993405659993,-1,6,5,11,11,-8
0,1.5373236649302704,2.0926432609558105,3.2170700073242187,1,2,3,6,6,-5
0,0.8944706915033658,3.929162866928998,3.514521026611328,3,2,5,6,6,-5
0,1.0144942823450498,4.701385498046875,4.769528706868489,-1,5,4,18,18,-10
0,0.9692892728985206,5.85869394938151,5.678769198330966,3,3,6,7,7,-6
0,1.0523448075844979,4.360951741536458,4.589224921332465,0,2,2,3,3,-2
0,0.9508180579530363,4.972002983093262,4.727470220521439,-5,8,3,4,4,-3
0,0.8922949814260864,3.9019783867730036,3.4817157321506076,0,3,3,5,5,-3
0,1.0221669778210494,4.23124395098005,4.325037841796875,-3,5,2,3,3,-2
0,1.2101919707115398,2.867375035439768,3.470074244907924,-3,7,4,5,5,-4
0,1.1060749299238084,4.042849540710449,4.471694522433811,2,3,5,6,6,-5
0,1.0224168746055882,4.151788150562959,4.244858264923096,-2,5,3,4,4,-3
0,0.969296821589849,4.020102280836839,3.89667236328125,-1,5,4,6,6,-4
0,0.977230547341529,4.489168857006317,4.386952939240829,-1,4,3,4,4,-3
0,0.9397670016484593,4.067519692813649,3.822520785861545,1,3,4,5,5,-4
0,1.0163947124468575,4.69495595296224,4.771928405761718,0,5,5,9,9,-6
0,1.0679101981717993,4.573841592539912,4.8844520814957155,8,6,14,18,18,-17
0,0.9885764076216039,4.569920131138393,4.517715226358442,4,2,6,7,7,-6
0,0.8853042008638086,4.358829000721807,3.858889625186012,-2,4,2,3,3,-2
0,0.6754370871663142,5.611617088317871,3.7902943004261362,-5,8,3,9,9,-8
0,0.9812749983394394,4.031506187037418,3.9560162269905823,-3,10,7,8,8,-7
0,1.303380221533846,2.6303040186564126,3.4282862345377603,0,2,2,3,3,-2
0,1.0361363713100087,3.879016876220703,4.0191904703776045,-1,3,2,3,3,-2
0,0.9487097706022594,4.967409406389509,4.712629838423296,1,2,3,4,4,-3
0,0.9861900598105885,4.052588858255526,3.996622848510742,-1,3,2,5,5,-2
0,0.965036533954573,5.0959743376701105,4.9178014119466145,-1,3,2,8,8,-7
0,0.9978825904138672,4.355400368019387,4.346178201528696,-1,4,3,23,23,-20
0,0.9919004589148005,4.46561336517334,4.429443946251502,2,2,4,5,5,-4
0,1.1113903031836452,5.548329671223958,6.16635979546441,3,2,5,6,6,-5
0,0.6918764606022758,4.546136743882123,3.145364999771118,-9,13,4,5,5,-4
0,1.0437210090738989,4.59947259085519,4.800566173735119,-7,9,2,3,3,-2
0,0.9720152564731667,4.9022773742675785,4.765088399251302,-2,4,2,3,3,-2
0,0.8826260382552593,5.107292522083629,4.507829364977385,-3,6,3,6,6,-4
0,1.019716331467787,4.467638778686523,4.555724225725446,-5,7,2,4,4,-3
0,0.7839528054542303,5.04773930140904,3.9571893865411933,-3,6,3,8,8,-4
0,1.0054485774809876,3.682857695079985,3.702924030583079,-1,4,3,4,4,-3
0,1.0218929885528765,3.9063401222229004,3.991861581802368,0,3,3,4,4,-3
0,0.8965538429616182,5.42970839790676,4.8680259303042765,-4,7,3,12,12,-3
0,0.8977921009293859,3.37500246109501,3.0300505501883372,-3,5,2,8,8,-7
0,0.9502514015854368,5.209336780366444,4.950179576873779,-5,7,2,5,5,-2
0,1.1884789527229005,4.6195526123046875,5.490241050720215,-1,4,3,5,5,-4
0,0.7741789211768205,3.340841119939631,2.586408774058024,1,2,3,4,4,-3
0,1.11142263104742,4.1776257683249085,4.643107822963169,-3,5,2,7,7,-2
0,1.105627339802886,4.973076502482097,5.498369344075521,-9,11,2,3,3,-2
0,0.9907199902291404,5.354272751581101,5.304585048130581,-7,10,3,7,7,-4
0,0.7608968811932182,4.943941116333008,3.761829376220703,2,2,4,5,5,-4
0,0.9489202820182864,4.099811863254857,3.890394629501715,4,3,7,8,8,-7
0,1.0287448836338733,4.552398681640625,4.683256851999383,1,3,4,5,5,-4
0,1.0607424983025913,4.395534842354911,4.662530610055635,-2,4,2,4,4,-2
0,0.9582062897227039,4.778850756193462,4.579124852230675,0,2,2,6,6,-2
0,1.0218430589014038,6.635615348815918,6.780557485727163,-3,5,2,3,3,-2
0,1.0664492662057046,4.201012059261925,4.480166227921195,4,3,7,9,9,-6
0,1.1961606841826233,3.826525115966797,4.577138900756836,-3,6,3,7,7,-5
0,0.832202314334372,3.706205959977775,3.084313177293347,2,4,6,7,7,-6
0,0.8874886071829986,4.774262604890047,4.237103669539742,-31,33,2,6,6,-4
0,0.8091128700214556,5.076063919067383,4.107108645968967,-2,5,3,7,7,-3
0,1.0410734469720293,4.173398281665558,4.344814134680706,-1,3,2,3,3,-2
0,0.9204455554189516,4.987046675248579,4.590304946899414,-2,5,3,5,5,-4
0,1.0317832036508174,4.626348495483398,4.773388671875,-2,5,3,4,4,-3
0,0.9901200929780972,4.297299260678499,4.254842343537704,0,3,3,4,4,-3
0,1.0061729193010838,4.585406963641827,4.613712310791016,0,2,2,3,3,-2
0,0.953810865319274,4.458192825317383,4.2522727564761515,-1,3,2,3,3,-2
0,0.9839865445776037,3.7315101623535156,3.671755790710449,-12,15,3,6,6,-4
0,0.96528274361807,5.100239054361979,4.923172747502561,1,2,3,4,4,-3
0,1.0033361218294614,4.560690174932065,4.575905192982066,-1,4,3,4,4,-3
0,0.9817288619697153,4.600192822908101,4.516142064874822,3,2,5,8,8,-7
0,0.9386321166473159,4.4194080352783205,4.1481983184814455,0,4,4,5,5,-4
0,1.0286859766346719,3.6067072550455728,3.7101691750919117,1,3,4,5,5,-3
0,0.9658272151755051,4.393818890606916,4.243669863100405,0,2,2,3,3,-2
0,1.0830515377509518,3.6207630504261363,3.9214729895958533,-3,6,3,4,4,-3
0,1.0287876399997404,5.584392070770264,5.745153539321002,1,2,3,6,6,-3
0,0.9671762145232269,6.068523265697338,5.869331359863281,1,2,3,4,4,-3
0,0.9365300314782008,3.657952880859375,3.425782726657006,1,2,3,4,4,-3
0,0.9481672729309288,5.491991315569196,5.207326428643588,1,3,4,5,5,-4
0,0.7666148338657194,4.633634065326891,3.552212609185113,-10,12,2,3,3,-2
0,0.9344302717158222,4.7319895426432295,4.421714274088542,0,3,3,4,4,-3
0,1.0203238247116626,5.170375221653988,5.275457021352407,-1,3,2,3,3,-2
0,1.0028268489657137,4.0820223721590905,4.093561632879849,3,2,5,6,6,-5
0,1.0026287575556694,5.195443289620536,5.2091008504231775,2,2,4,5,5,-4
0,1.0968142573903665,4.197378431047712,4.6037445068359375,6,2,8,9,9,-8
0,0.85599249507765,4.604866691257643,3.9417313285495923,0,3,3,7,7,-6
0,0.9633481081170872,4.592908223470052,4.424569447835286,3,4,7,10,10,-9
0,1.0566578042139732,5.060486929757254,5.34720300745081,-1,3,2,3,3,-2
0,1.0144297969311957,4.386992021040483,4.4502954250428735,-3,6,3,4,4,-3
0,1.0667309329148056,5.531930220754523,5.901081085205078,1,2,3,4,4,-3
0,1.0149648685669252,4.879203796386719,4.952220439910889,-8,14,6,11,11,-7
0,1.042256147811121,4.494462966918945,4.684381658380682,1,3,4,6,6,-4
0,0.9567358285080592,3.951471964518229,3.780514803799716,2,2,4,5,5,-4
0,0.9195076753592913,4.243412017822266,3.9018499200994317,0,4,4,6,6,-4
0,1.0306968613335705,4.153838157653809,4.2813479515814015,-1,3,2,8,8,-6
0,1.0130788773486707,4.439017209139737,4.497074570766715,-1,4,3,5,5,-3
0,1.033475577869146,4.5065452174136515,4.65740442276001,-3,6,3,4,4,-3
0,1.018022551241127,4.754841613769531,4.840535990397135,-15,19,4,6,6,-4
0,0.9925088738376484,4.810950939471905,4.774911499023437,-1,3,2,3,3,-2
0,1.0187104773516855,4.6724901701274675,4.759914691631611,1,2,3,5,5,-3
0,1.0457337293675701,3.66845457015499,3.8362266786636843,0,2,2,6,6,-2
0,0.9976991972487917,4.93182373046875,4.920476576861213,2,2,4,5,5,-4
0,1.1080251779123091,4.998664855957031,5.538646516345796,-5,9,4,5,5,-4
0,1.0880529815280329,3.916937691824777,4.2618357340494795,0,3,3,4,4,-3
0,1.1935739278756259,4.9597133513419855,5.9197845458984375,-12,14,2,3,3,-2
0,1.0313427497065093,4.732827273282138,4.881167093912761,1,3,4,8,8,-4
0,1.0319576858889576,4.578193664550781,4.724502139621311,1,3,4,6,6,-4
0,0.9835480098306868,5.3432476337139425,5.255340576171875,0,2,2,5,5,-2
0,1.1392639943889151,5.574861450195312,6.351238923914292,-8,12,4,8,8,-3
0,1.0007912243805746,3.5986456189836775,3.601492955134465,-1,3,2,3,3,-2
0,0.9023996377587218,4.66939365162569,4.213659139779898,-4,10,6,9,9,-6
0,1.0030932517499804,4.7021960090188415,4.71674108505249,-2,5,3,4,4,-3
0,1.0079773369308005,3.4710919516427174,3.4987820216587613,0,2,2,3,3,-2
0,1.2596560242783466,3.5926181568818936,4.525463104248047,-7,10,3,6,6,-3
0,1.000722947006074,5.770682719216418,5.774854617011278,-1,3,2,3,3,-2
0,1.0547702793454987,5.0337140764508925,5.309412002563477,-19,23,4,14,14,-13
0,1.0473035759303406,4.402346716986762,4.610593459185432,-1,3,2,3,3,-2
0,1.0178720029143475,4.908484825721154,4.996209280831473,2,2,4,5,5,-4
0,1.0255141889308483,4.874798478751347,4.999175008138021,1,3,4,12,12,-7
0,1.1111080876611241,3.5282950150339225,3.920317126858619,-7,10,3,4,4,-3
0,0.9515118642655992,4.075094925729852,3.8775011698404946,-1,3,2,3,3,-2
0,1.003226637627576,3.925412859235491,3.9380787440708707,-7,9,2,4,4,-2
0,0.9616972119523279,4.480450239337858,4.308836503462358,-17,21,4,15,15,-14
0,0.9909841072360938,4.259926795959473,4.221519752785012,-5,7,2,4,4,-3
0,0.9238117156727442,4.390755844116211,4.056231689453125,0,4,4,6,6,-5
0,0.9691739379441886,5.166813569910386,5.00754105417352,2,3,5,6,6,-5
0,0.9054000155449654,3.644469041090745,3.2997023264567056,-1,5,4,6,6,-5
0,0.8646109393425173,4.935350735982259,4.267158235822405,2,2,4,6,6,-4
0,0.9772824937826601,5.051625569661458,4.936865234375,-5,9,4,5,5,-4
0,0.9862291107621716,4.904718572443182,4.837176236239347,0,4,4,5,5,-4
0,0.991105708381186,3.94671630859375,3.9116130628083883,-3,5,2,3,3,-2
0,0.8903847733352681,4.754850968070652,4.233646901448568,-8,10,2,3,3,-2
0,1.0184455043189597,4.492018600990033,4.574876149495442,-5,13,8,16,16,-9
0,0.9884271758917449,4.204235783329716,4.15558090209961,3,2,5,6,6,-5
0,0.9538193888963702,3.9452750466086646,3.763079833984375,2,5,7,8,8,-7
0,1.0341182710042158,6.772437054177989,7.003500896951427,0,4,4,10,10,-4
0,0.9215867158649194,4.429749599722928,4.082398385712595,-10,12,2,3,3,-2
0,1.0139244728849144,4.245269188514123,4.30438232421875,0,2,2,3,3,-2
0,1.0042197316329688,4.861701378455529,4.882216453552246,-1,3,2,3,3,-2
0,1.0038349091560594,4.887841266134511,4.906585693359375,-1,3,2,7,7,-6
0,0.9502825131036226,4.080824110243055,3.877935791015625,-6,9,3,4,4,-3
0,0.9735800233247065,5.2702997843424475,5.131058586968316,6,2,8,9,9,-8
0,0.976574913430456,4.805792172749837,4.693216075067935,-2,5,3,6,6,-3
0,0.9472963720528114,4.7221527099609375,4.4732781304253475,-15,18,3,4,4,-3
0,1.0098192653476183,4.050269535609654,4.09004020690918,0,3,3,4,4,-3
0,0.8454693875933053,2.646409511566162,2.2374582290649414,0,2,2,3,3,-2
0,1.0119950372586473,4.713287353515625,4.769823410931756,-1,3,2,3,3,-2
0,1.1688046345000649,4.934098434448242,5.76699711726262,3,2,5,6,6,-5
0,0.8338888002262056,4.22217041015625,3.5208206176757812,-5,11,6,7,7,-6
0,1.0565091935022848,4.727962277970224,4.995135613207547,0,4,4,5,5,-4
0,1.0724397268846353,4.390382272225839,4.708420364945023,0,3,3,5,5,-3
0,0.8281608681186496,3.7262916564941406,3.0859689331054687,3,4,7,9,9,-8
0,1.011867805849809,5.17212823096742,5.233510044642857,-12,16,4,6,6,-5
0,1.0252306622973075,4.188416522482167,4.294093045321378,-1,6,5,6,6,-5
0,0.9014911872115189,4.539778645833334,4.092570441109793,-1,6,5,8,8,-5
0,1.173112371718793,5.754479726155599,6.7506513595581055,-1,4,3,4,4,-3
0,0.9275079460826392,3.8365809122721353,3.5584592819213867,-7,9,2,3,3,-2
0,1.0493954678290367,3.6852981567382814,3.867335183279855,-6,8,2,3,3,-2
0,1.1287238617179025,3.8815402560763888,4.381187107252038,1,3,4,7,7,-4
0,1.0651102947606137,6.516442775726318,6.940730285644531,-2,8,6,7,7,-6
0,0.9947703464676547,4.012458801269531,3.9914750319260817,-3,6,3,9,9,-3
0,0.9522644053309838,5.458134299830387,5.197587013244629,-3,7,4,6,6,-5
0,1.0266783531547505,4.632347896181304,4.755931309291294,-8,11,3,4,4,-3
0,1.0052619148351083,5.138031959533691,5.165067846124822,-10,13,3,4,4,-3
0,0.9940303560599906,4.877489407857259,4.848372532771184,2,3,5,6,6,-5
0,0.9328359901972013,3.8586290799654446,3.599468078613281,-1,4,3,4,4,-3
0,0.8569251410698936,5.677221934000651,4.864954206678602,0,3,3,4,4,-3
0,1.068412556099474,3.023761204310826,3.2306244373321533,4,2,6,7,7,-6
0,0.9773620868773908,3.7554852803548178,3.6704689308449074,-3,5,2,3,3,-2
0,1.0439229170721163,3.9044137252004525,4.075906965467665,-2,4,2,3,3,-2
0,1.0383995480527366,5.368391707136825,5.574535522460938,-12,15,3,10,10,-9
0,0.9986433569446356,5.183801130814985,5.176768563010476,0,3,3,4,4,-3
0,1.029573423176181,3.590406475645123,3.696587085723877,-1,3,2,4,4,-2
0,1.0671773080332165,3.4284173716669497,3.6587292215098506,0,3,3,4,4,-3
0,1.0311656971668683,2.9362019432915583,3.027710723876953,-3,7,4,5,5,-4
0,1.1240086835762428,3.5105282176624644,3.945864200592041,-3,5,2,3,3,-2
0,1.0718720890483036,3.3726781209309897,3.615079543169807,-1,4,3,5,5,-3
0,0.9341277152572205,5.0134282265940024,4.683182254914315,0,2,2,6,6,-2
0,1.0525095741036892,4.611025619506836,4.853148610968339,-1,3,2,3,3,-2
0,0.8223901137650094,5.48350867446588,4.509583322625411,-11,15,4,6,6,-4
0,0.9461090437519307,5.9187732272677955,5.599804878234863,-2,6,4,14,14,-4
0,1.005000423978086,5.348155975341797,5.37489902271944,-3,5,2,4,4,-2
0,1.0064452534195478,5.291994961825284,5.326103210449219,0,2,2,4,4,-2
0,0.9030454443967728,5.08692372639974,4.593723297119141,-8,11,3,12,12,-4
0,0.6789079757540909,3.980541229248047,2.702421188354492,4,4,8,9,9,-8
0,0.9931676421044243,5.115758356058373,5.0808056640625,-3,5,2,4,4,-2
0,1.034277461169792,4.828989868164062,4.994515380859375,0,5,5,6,6,-5
0,1.0630811798538737,5.559303001121238,5.9099903935971465,-4,7,3,5,5,-3
0,1.042901179916651,4.080512823060501,4.255571637834821,-1,3,2,3,3,-2
0,0.9748891937668349,5.078282563582711,4.950762794131324,-2,5,3,7,7,-4
0,1.0630244465485221,3.586563511898643,3.812604692247179,-2,7,5,11,11,-6
0,1.1495491900244037,4.0198605445123485,4.621027432955229,-5,8,3,7,7,-6
0,0.8356978484660464,4.646500905354817,3.883070809500558,-4,6,2,4,4,-2
0,1.0753074894485255,4.6761974466258085,5.028350136496804,-7,9,2,3,3,-2
0,0.9442955073196212,5.297581898082386,5.002482786016949,4,2,6,18,18,-6
0,1.033172486885361,4.7483266194661455,4.905840421977796,1,2,3,4,4,-3
0,0.8210839962576366,4.141263058311061,3.400324821472168,-7,9,2,3,3,-2
0,0.9906165707943846,3.326909935992697,3.2956921121348506,0,2,2,3,3,-2
0,1.1071535279552487,6.144904192756204,6.803352355957031,-1,5,4,5,5,-4
0,0.9738127186196819,4.417553424835205,4.301869710286458,-4,8,4,8,8,-6
0,1.1007889936809594,3.1969517299107144,3.5191692776150174,-3,6,3,6,6,-5
0,0.9984243128937845,4.757142808702257,4.74964704011616,2,2,4,5,5,-4
0,1.0029916029403678,4.303781236921038,4.316656441524111,1,4,5,6,6,-5
0,0.9946130439066965,4.188504269248561,4.165940980653505,-1,3,2,3,3,-2
0,0.9290110554903225,4.67614052512429,4.344186244866787,-5,8,3,5,5,-4
0,0.9775632976037419,4.576732788085938,4.474045996572457,1,2,3,6,6,-2
0,0.9428855818729107,4.619527670053335,4.35568603515625,-1,4,3,5,5,-3
0,0.7820394884633174,5.677191543579101,4.439787970648871,-1,4,3,7,7,-5
0,0.9412893087377067,4.893381292169744,4.606087493896484,-1,4,3,5,5,-3
0,1.1494284110041124,4.034078280131022,4.636884187397204,7,4,11,16,16,-13
0,0.9152700440391028,4.337977968413254,3.9704212861902572,5,2,7,8,8,-7
0,0.9437377047689373,5.350950374159702,5.049893624441964,-8,13,5,8,8,-6
0,1.1090823121411333,3.166724068777902,3.5121576521131725,4,3,7,8,8,-7
0,1.020459250757607,4.604998588562012,4.6992134094238285,2,3,5,8,8,-5
0,0.8875572996418021,4.068683399873621,3.6111896514892576,3,3,6,13,13,-6
0,1.0868069166116041,5.038620948791504,5.4760080973307295,5,2,7,8,8,-7
0,0.9840840066114648,4.001474820650541,3.9377873738606772,-4,6,2,3,3,-2
0,1.1405234409137115,4.328019460042317,4.936207646908968,-1,4,3,4,4,-3
0,1.0824258400136888,4.863221849714007,5.264076995849609,-8,10,2,3,3,-2
0,1.0963689423813665,4.90894535609654,5.382015228271484,0,3,3,5,5,-3
0,0.8931157672342185,4.8197182103207235,4.304566327263327,-2,5,3,4,4,-3
0,0.6703764293413373,3.7254918416341147,2.497481918334961,1,4,5,6,6,-5
0,0.9185351696587302,4.873390197753906,4.476380292107077,0,3,3,5,5,-3
0,1.0360247468868222,4.351819719587054,4.508592923482259,-9,11,2,8,8,-2
0,0.8715660241842816,4.742780118375211,4.133646011352539,-5,9,4,5,5,-4
0,0.9174285849970252,5.3462096320258246,4.904765537806919,3,2,5,17,17,-5
0,0.9596287375825988,4.347756807921363,4.172232376901727,-4,6,2,8,8,-2
0,1.1276613961603996,4.565282721268503,5.148093087332589,2,2,4,8,8,-5
0,1.1733215711238405,4.3694334763747,5.1267505514210665,3,3,6,7,7,-6
0,0.8637418678992014,5.0539473470052085,4.365305921766493,-30,32,2,10,10,-8
0,0.9360501854614957,3.1553449630737305,2.953561237880162,-1,3,2,3,3,-2
0,0.9847054317097982,5.385736083984375,5.303363575654871,-1,3,2,3,3,-2
0,1.1650043010918016,3.2792670208474863,3.8203601837158203,-3,8,5,6,6,-5
0,0.791052578104258,3.1162787543402777,2.4651403427124023,-1,3,2,5,5,-2
0,1.0393996935891074,4.0429850039274795,4.202277374267578,-3,6,3,4,4,-3
0,1.0495070115374514,3.5215877409904235,3.6959310259137834,-3,6,3,4,4,-3
0,0.9470325986661801,4.6521782875061035,4.405764493075284,1,3,4,6,6,-4
0,1.0595978005507691,4.812294642130534,5.099096818403765,-2,4,2,3,3,-2
0,0.8580422787493063,4.183707827613468,3.5897981980267692,-4,7,3,4,4,-3
0,0.7408790148178995,3.8877348466352983,2.8803411630483775,-9,11,2,3,3,-2
0,1.0667569400288712,4.641850062779018,4.951725769042969,-1,3,2,3,3,-2
0,0.8786464726321718,5.328403614185475,4.681783040364583,0,2,2,3,3,-2
0,0.9222106250687904,4.643197631835937,4.282006190373347,2,2,4,5,5,-4
0,0.972610519182646,3.890289306640625,3.783736302302434,0,2,2,3,3,-2
0,1.0543578902796893,4.220447193492543,4.449861798967634,-1,4,3,6,6,-3
0,1.0350080836933497,4.289573669433594,4.439743423461914,0,2,2,7,7,-2
0,0.976766539271796,4.91989278793335,4.805586652057927,-23,27,4,5,5,-4
0,2.099086756170416,2.057193565368652,4.318227767944336,3,2,5,6,6,-5
0,1.0241894168964625,4.522931671142578,4.632338750930059,1,2,3,4,4,-3
0,1.0064320735941006,4.381256690392127,4.409437255859375,-1,6,5,6,6,-5
0,0.9467482198281697,6.519002641950335,6.171854146321615,1,2,3,4,4,-3
0,1.18011302594593,4.513214111328125,5.326102761661305,-3,6,3,11,11,-10
0,1.0917498643951005,4.06433900197347,4.437241554260254,0,3,3,7,7,-4
0,0.7233756033413001,4.85745096206665,3.513761520385742,-6,9,3,7,7,-4
0,1.004343854974991,4.4772865988991475,4.496735282566236,1,5,6,7,7,-6
0,0.9690752518448125,5.188590720847801,5.02813485952524,-2,5,3,6,6,-3
0,0.8406764358534885,4.136238098144531,3.477237902189556,-19,21,2,5,5,-2
0,1.0763284413544296,4.665627699631911,5.021747789884868,6,4,10,11,11,-10
0,1.0146697338400257,4.535715888528263,4.602253633386948,0,3,3,4,4,-3
0,1.224137536393378,3.9924180772569446,4.887268829345703,1,3,4,5,5,-4
0,0.981718742686657,4.591886875993114,4.507941410459321,-1,4,3,8,8,-6
0,0.961613875650344,4.94218635559082,4.752474975585938,0,2,2,3,3,-2
0,0.8187432336729522,6.479907989501953,5.305380821228027,0,4,4,7,7,-4
0,1.0346477522783322,4.622313759543679,4.782466541637074,-11,14,3,6,6,-4
0,0.9011395181277396,5.340497589111328,4.812533424014137,1,3,4,6,6,-5
0,1.38981929441063,3.6967150370279946,5.137765884399414,1,6,7,10,10,-9
0,1.1003002220695537,4.326601155598959,4.760560212311922,-3,6,3,6,6,-3
0,1.087678571816533,4.15015272660689,4.5140321904962715,0,2,2,3,3,-2
0,0.9480821896164724,4.120981631071671,3.907029288155692,-2,4,2,3,3,-2
0,1.072640441399992,4.506935382711476,4.834321158272879,-1,3,2,3,3,-2
0,0.958782576757038,4.6778312683105465,4.485023117065429,0,4,4,5,5,-4
0,1.0368648036644859,4.258741809475806,4.4157394901398686,0,5,5,6,6,-5
0,1.1398083040634064,4.140220642089844,4.719057868508732,2,3,5,6,6,-5
0,1.082346710723613,4.733888479379507,5.123708624588816,6,4,10,11,11,-10
0,0.9171246258081746,5.0402346010561345,4.622523272479022,0,2,2,3,3,-2
0,0.8700687079798969,4.2870705344460225,3.7300459209241366,-3,7,4,6,6,-4
0,0.8659509066713597,5.322061767578125,4.608644212995257,-18,20,2,3,3,-2
0,0.9553143075710968,4.955781763250178,4.7343292236328125,-1,3,2,4,4,-2
0,1.0919927081446206,4.492071242559524,4.9053090413411455,-3,8,5,15,15,-7
0,0.9754150985270649,4.896686422413793,4.77630186917489,-1,3,2,3,3,-2
0,0.9854229319182601,4.356254577636719,4.292753158077117,-1,3,2,3,3,-2
0,0.9009813311308399,4.0271444881663605,3.628382001604353,4,2,6,7,7,-6
0,0.514683746323165,5.4568986892700195,2.808577060699463,-24,27,3,4,4,-3
0,0.8840925187446912,4.687391094132965,4.144087398753447,-17,24,7,8,8,-7
0,0.9370875169410621,2.5573220934186662,2.396434610540217,4,2,6,7,7,-6
0,0.9186351311823847,5.804253522087546,5.331991195678711,-1,5,4,5,5,-4
0,0.6241258687441767,3.410474337064303,2.1285652584499783,-4,6,2,3,3,-2
0,0.8991417188312852,3.9203091789694393,3.524913533528646,-2,4,2,3,3,-2
0,0.7802380199441518,3.8158887227376304,2.977301461356027,-22,24,2,6,6,-2
0,0.8521476164559685,3.783530426025391,3.224126434326172,0,2,2,3,3,-2
0,0.9613937855781685,3.4588333129882813,3.325300852457682,-3,5,2,3,3,-2
0,1.0347238966113834,4.634274291992187,4.795194353376116,-1,3,2,3,3,-2
0,1.0348251045397534,4.476249107947717,4.632134951077974,0,3,3,4,4,-3
0,0.9763238862264009,5.181979709201389,5.0592905680338545,-9,12,3,5,5,-4
0,0.9881733118711266,4.865760354434743,4.808214524213006,0,2,2,3,3,-2
0,1.0406981674508333,3.876059158988621,4.033807663690476,-4,7,3,4,4,-2
0,0.9899971152194946,4.483792818509615,4.438941955566406,-1,4,3,8,8,-7
0,1.2081176652037808,4.020314534505208,4.857013008811257,1,6,7,10,10,-7
0,0.9967916244947305,4.943327985491071,4.927467933067908,-22,25,3,10,10,-4
0,1.0535465327081488,3.7817064921061196,3.9842037624782987,0,3,3,4,4,-3
0,1.0287608096356151,4.258504427396334,4.380982462565104,-7,11,4,7,7,-5
0,0.9919369769882276,3.94388484954834,3.912085215250651,-2,4,2,6,6,-2
0,1.0741331746386895,3.908165613810221,4.1978903377757355,-7,10,3,6,6,-5
0,0.9632819475544585,5.252382755279541,5.059525489807129,0,2,2,3,3,-2
0,1.0459590047100558,4.259342193603516,4.4550973215410785,-5,7,2,6,6,-2
0,0.937571220124711,4.866213198061343,4.562421445493345,0,5,5,7,7,-5
0,1.0411505552983011,6.113158331976996,6.364718191964286,-1,3,2,3,3,-2
0,0.9474187052901749,5.797354125976563,5.492521740141369,-9,15,6,17,17,-7
0,0.9780211316493931,4.915725390116374,4.8076833089192705,0,3,3,4,4,-3
0,1.3223500223176106,3.8637793404715404,5.1092686971028645,-6,9,3,4,4,-3
0,1.0538308012137898,4.764868259429932,5.0213649355132,-3,6,3,4,4,-3
0,0.7552883228181365,4.429429054260254,3.345496041434152,-2,4,2,4,4,-2
